40
30
15,15,15,15,15,15,15,15,15,15,19,19,19,19,19,19,19,19,19,19,19,19,193,193,209,209,209,193,193,19,19,19,19,19,19,19,19,19,19,19,
15,15,68,68,15,15,15,15,15,19,19,19,19,19,19,19,19,19,19,19,19,19,193,209,209,209,209,193,19,19,19,19,19,19,71,19,19,19,19,19,
15,68,68,15,15,15,15,15,19,19,19,19,19,19,19,19,19,19,19,19,19,19,193,209,209,209,193,193,19,19,19,19,19,19,71,19,19,19,19,19,
15,68,15,15,15,15,15,19,19,19,19,19,19,19,19,19,19,19,19,19,19,193,193,209,209,209,193,19,19,19,19,19,19,19,19,19,19,19,19,19,
15,15,15,15,15,15,19,19,19,19,19,19,19,19,19,19,19,71,19,19,19,193,209,209,209,193,193,19,19,19,19,19,19,19,19,19,19,19,19,19,
15,15,15,15,15,19,19,19,19,19,19,19,19,19,19,19,19,71,19,19,193,193,209,209,193,193,19,19,19,19,19,19,19,19,19,193,193,193,193,193,
15,15,15,15,19,19,19,19,19,19,19,19,19,19,19,19,19,19,19,193,193,209,209,209,193,19,19,19,19,19,19,193,193,193,193,193,209,209,209,209,
15,15,15,19,19,19,19,19,19,19,19,19,19,19,19,19,19,193,193,193,209,209,209,209,193,193,193,193,193,193,193,193,209,209,209,209,209,209,209,209,
15,15,15,19,19,19,19,71,19,19,19,19,19,19,19,19,193,193,209,209,209,209,193,193,209,209,209,209,209,209,209,209,209,209,209,193,193,193,193,193,
15,15,19,19,19,19,19,71,19,19,19,19,19,19,19,19,193,209,209,209,209,209,209,209,209,209,209,193,193,193,193,193,193,193,193,19,19,19,19,19,
15,15,19,19,19,19,19,19,19,19,19,19,19,19,193,193,209,209,209,209,209,209,209,193,193,193,193,19,19,19,19,19,19,19,19,19,19,19,19,19,
15,19,19,19,19,19,19,19,19,19,19,19,193,193,209,209,209,209,209,193,193,193,193,19,19,19,19,19,19,71,19,19,19,19,19,19,19,19,19,19,
19,19,19,19,19,19,19,19,19,19,19,193,209,209,209,209,209,193,193,19,19,19,19,19,19,19,19,19,19,71,19,19,19,19,19,19,19,19,19,19,
19,19,19,19,19,19,19,19,19,193,193,209,209,209,209,209,193,19,19,19,19,19,19,19,19,19,19,19,19,19,19,19,19,19,19,19,19,19,19,19,
19,19,19,19,19,19,19,19,193,209,209,209,209,193,193,193,19,19,19,19,19,19,19,19,19,19,19,19,19,19,19,19,19,19,19,19,19,19,19,19,
19,19,19,19,19,19,19,193,209,209,209,193,193,19,19,19,19,19,19,19,19,19,19,19,19,19,19,19,19,19,19,19,19,19,19,19,19,19,19,19,
19,19,19,19,19,19,193,209,209,209,193,19,19,19,19,19,19,19,19,19,19,19,19,19,19,19,19,19,19,19,19,19,19,17,19,19,19,19,19,19,
19,19,19,19,19,19,193,209,209,209,193,19,71,19,19,19,19,19,19,193,19,19,19,19,19,19,71,19,19,19,19,19,17,17,17,19,19,19,19,19,
19,19,19,19,19,19,193,209,209,209,193,19,71,19,19,19,19,19,193,193,193,19,19,19,19,19,71,19,19,19,19,17,17,55,17,17,19,19,19,19,
19,19,19,19,19,193,193,209,209,193,19,19,19,19,19,19,19,19,19,193,19,19,19,19,19,19,19,19,19,19,17,17,55,102,55,17,17,19,19,19,
19,19,19,19,19,193,209,209,209,193,19,19,19,19,19,19,19,19,19,19,19,19,19,19,19,18,19,19,121,17,17,55,102,66,102,55,17,17,121,19,
19,19,19,19,193,193,209,209,193,19,19,19,19,19,19,19,19,19,19,19,19,19,19,19,18,239,18,19,17,17,55,55,66,213,66,55,55,17,17,19,
19,19,193,193,209,209,209,209,193,193,193,193,193,193,193,193,19,19,19,19,19,19,19,19,19,18,19,19,17,37,74,74,74,74,74,74,74,37,17,19,
193,193,209,209,209,209,209,209,209,209,193,209,209,209,209,209,193,193,193,193,193,193,193,19,19,19,19,19,19,37,74,50,88,199,88,50,74,37,19,19,
209,209,209,209,209,209,209,209,209,209,209,209,209,209,209,209,209,209,209,209,209,209,209,193,19,19,19,19,19,37,74,74,88,82,88,74,74,37,19,19,
209,209,209,209,209,209,193,193,193,193,209,209,209,209,209,209,209,209,209,209,209,209,209,209,193,19,19,19,19,37,74,74,88,98,88,74,74,37,19,19,
209,209,209,209,209,193,3,3,19,193,193,193,193,193,193,193,193,193,193,193,209,209,19,209,209,193,193,193,193,19,19,193,193,209,209,209,193,19,19,19,
209,209,209,193,193,3,3,3,3,19,19,19,19,19,19,19,19,19,19,19,193,193,209,209,209,209,209,209,209,193,193,209,209,209,209,193,19,19,19,19,
193,193,193,19,3,3,3,3,3,3,19,19,19,19,19,19,19,19,19,19,19,19,193,209,209,209,209,209,209,209,209,209,209,209,209,193,19,19,19,19,
19,19,19,19,3,3,3,3,3,3,19,19,19,19,19,19,19,19,19,19,19,19,19,193,193,209,209,209,209,209,209,209,209,209,209,193,19,19,19,19
77,0,0,0,0,0,0,0,77,0,0,0,0,0,0,0,0,0,0,30,0,0,0,0,0,0,0,0,0,0,0,0,0,0,0,0,0,0,30,0,
0,0,0,0,0,0,0,0,0,0,0,0,30,0,0,0,30,0,0,0,0,0,0,0,0,0,0,0,0,0,0,0,30,0,0,0,0,0,0,0,
0,0,0,0,77,0,0,0,0,0,0,0,0,0,0,0,0,0,0,0,0,0,0,0,0,0,0,56,0,0,0,0,0,0,0,0,56,0,0,0,
0,0,0,0,0,0,0,0,0,0,0,0,0,0,0,0,56,0,0,0,0,0,0,0,0,0,39,30,0,0,56,0,0,57,0,13,0,0,30,0,
0,0,0,0,0,77,0,0,30,0,0,0,0,0,0,0,0,0,0,0,0,0,0,0,0,0,0,0,0,0,0,0,14,0,30,0,0,0,0,0,
0,0,77,0,0,0,0,0,0,0,0,56,0,0,0,0,0,0,0,0,0,0,0,0,0,0,0,0,0,0,30,0,0,0,39,0,0,0,0,0,
0,0,0,0,0,0,0,0,0,0,0,0,0,57,0,0,0,0,0,39,0,0,0,0,0,0,0,0,0,0,0,0,0,0,0,0,0,0,0,0,
0,0,0,0,0,0,0,0,0,0,0,0,0,0,0,0,0,0,0,0,0,0,0,0,0,0,0,0,0,0,0,0,0,0,0,0,0,0,0,0,
0,0,0,0,0,0,30,0,0,14,0,0,0,0,0,0,0,0,0,0,0,0,0,0,0,0,0,0,0,0,0,0,0,0,0,0,0,0,0,0,
0,77,0,0,0,0,0,0,0,0,0,0,56,0,0,0,0,0,0,0,0,0,0,0,0,0,0,0,0,0,0,0,0,0,0,0,0,0,0,0,
0,0,0,0,0,0,0,0,0,0,0,0,0,0,39,0,0,0,0,0,0,0,0,0,0,0,0,0,0,0,0,30,0,0,0,0,0,0,0,0,
0,0,0,0,0,0,0,57,0,0,0,0,0,0,0,0,0,0,0,0,0,0,0,0,0,0,0,0,0,0,0,0,0,0,56,0,0,30,0,0,
0,0,0,30,0,0,0,0,0,0,0,0,0,0,0,0,0,0,0,56,0,0,0,0,0,0,0,0,0,0,0,0,0,0,0,0,0,0,0,0,
0,0,0,0,0,30,0,0,0,39,0,0,0,0,0,0,0,0,0,0,0,0,0,0,30,0,0,0,0,0,0,0,0,0,0,0,0,0,0,0,
0,0,0,0,0,0,0,0,0,0,0,0,0,0,0,0,0,0,0,0,0,0,30,0,0,0,57,0,0,0,0,0,0,30,0,0,56,0,0,0,
0,0,0,0,30,0,0,0,0,0,0,0,0,0,0,0,0,0,0,0,0,0,0,0,0,0,0,0,0,0,0,56,0,0,0,0,0,0,0,0,
0,0,0,0,0,0,0,0,0,0,0,0,0,0,0,0,30,0,0,0,0,0,0,0,0,0,0,0,0,14,0,0,0,0,0,0,0,0,30,0,
0,56,13,0,0,0,0,0,0,0,0,0,0,0,0,0,0,0,0,30,0,0,0,0,0,0,0,0,13,0,0,0,0,0,0,0,0,0,0,0,
0,0,0,0,0,0,39,0,0,0,0,0,0,0,0,0,0,30,0,0,0,56,0,0,0,0,0,0,0,0,0,0,0,0,0,0,0,0,0,0,
0,0,30,0,30,0,0,0,0,0,0,0,0,0,0,0,0,0,0,0,0,0,0,0,0,0,0,0,0,0,0,0,0,0,0,0,0,0,0,0,
0,0,0,0,0,0,0,0,0,0,0,0,0,0,56,0,0,0,14,0,0,0,0,0,0,0,0,0,0,0,0,0,0,81,0,12,0,0,0,0,
0,0,0,0,0,0,0,0,0,0,0,0,0,0,0,0,0,0,0,0,0,0,0,0,0,254,0,0,0,0,0,0,81,0,81,0,0,0,0,0,
0,0,0,0,0,0,0,0,0,0,39,0,0,0,0,0,0,0,0,0,0,0,0,0,0,0,0,0,0,156,0,0,0,0,0,0,0,156,0,0,
0,0,0,0,0,0,0,0,0,0,0,0,0,0,0,0,0,0,0,0,0,39,0,0,0,0,0,0,0,156,0,0,0,0,0,0,0,156,0,0,
0,0,0,0,0,0,0,0,0,0,0,0,0,0,0,0,0,0,0,0,0,0,0,0,0,0,0,0,0,156,0,0,86,0,86,0,0,156,0,0,
0,0,0,0,0,0,0,0,0,0,0,0,0,0,0,0,0,0,0,0,0,0,0,0,0,0,0,0,0,156,0,0,86,0,86,0,0,156,0,62,
0,0,0,0,0,0,90,90,0,0,0,0,39,0,0,0,0,0,0,0,0,0,0,0,0,0,0,0,0,0,0,0,0,0,0,0,0,0,0,0,
0,0,0,0,0,90,92,92,90,0,0,0,0,0,0,0,0,0,0,0,0,0,0,0,0,0,0,0,0,0,39,0,0,0,0,0,0,0,0,0,
0,0,0,0,90,91,91,92,92,90,57,0,0,0,57,0,0,0,0,0,0,0,0,0,0,0,0,0,0,0,0,0,0,0,0,0,0,0,0,0,
0,0,0,57,90,90,92,92,92,92,0,0,0,0,0,0,0,57,0,0,0,0,0,39,0,0,0,0,0,0,0,0,0,0,0,0,0,0,0,0
