20
20
1,1,1,1,1,1,1,1,1,1,1,1,1,1,1,1,1,1,1,1,
1,1,1,1,1,1,1,1,1,1,1,1,1,1,1,1,1,1,1,1,
1,1,1,1,1,1,1,1,1,1,1,1,1,1,1,1,1,1,1,1,
1,1,1,1,1,1,1,1,1,1,1,1,1,1,1,1,1,1,1,1,
1,1,1,1,1,1,1,1,1,1,1,1,1,1,1,1,1,1,1,1,
1,1,1,1,1,1,1,1,1,1,1,1,1,1,1,1,1,1,1,1,
1,1,1,1,1,1,1,1,1,1,1,1,1,1,1,0,0,0,0,0,
1,1,1,1,1,1,1,1,1,1,1,1,0,0,0,0,0,0,0,0,
0,0,0,0,0,0,1,1,1,1,1,1,1,1,1,1,1,0,0,0,
0,0,0,0,1,1,0,0,0,0,0,0,1,1,1,0,0,0,0,0,
0,0,0,1,1,0,0,0,0,1,1,1,1,0,0,0,0,0,0,0,
0,0,1,1,0,0,0,1,1,1,0,0,0,0,0,0,0,0,0,0,
0,1,1,0,0,0,0,0,1,1,1,1,1,1,1,1,0,0,0,0,
0,1,1,1,1,1,1,1,1,1,1,1,1,1,0,0,0,0,0,0,
0,0,1,1,1,1,1,1,1,1,1,1,1,1,0,0,0,0,0,0,
0,0,0,1,1,1,0,0,0,0,0,0,0,1,1,1,0,0,0,0,
0,0,0,1,1,1,1,1,1,1,1,1,1,1,1,0,0,0,0,0,
0,0,1,1,1,1,1,1,1,1,1,1,1,1,1,1,1,0,0,0,
0,0,0,0,0,0,0,0,0,0,0,0,0,0,0,0,0,0,0,0,
0,0,0,0,0,0,0,0,0,0,0,0,0,0,0,0,0,0,0,0
0,0,0,0,0,0,0,0,0,0,0,0,0,0,0,0,0,0,0,0,
0,0,0,0,0,0,0,0,0,0,0,0,0,0,0,0,0,0,0,0,
0,0,0,0,0,0,0,0,0,0,0,0,0,0,0,0,0,0,0,0,
0,0,0,0,0,0,0,0,0,0,0,0,0,0,0,0,0,0,0,0,
0,0,0,0,0,0,0,0,0,0,0,0,0,0,0,0,0,0,0,0,
0,0,0,0,0,0,0,0,0,0,0,0,0,0,0,0,0,0,0,0,
0,0,0,0,0,0,0,0,0,0,0,0,0,0,0,0,0,0,0,0,
0,0,0,0,0,0,0,0,0,0,0,0,0,0,0,0,0,0,0,0,
0,0,0,0,0,0,0,0,0,0,0,0,0,0,0,0,0,0,0,0,
0,0,0,0,10,10,0,0,0,0,0,0,0,0,0,0,0,0,0,0,
0,0,0,10,10,0,0,0,0,0,0,0,0,0,0,0,0,0,0,0,
0,0,0,10,0,0,0,0,70,0,0,0,0,0,0,0,0,0,0,0,
0,70,10,0,0,0,0,0,78,0,0,0,0,0,0,0,0,0,0,0,
0,78,10,0,10,10,10,10,70,0,0,0,0,0,0,0,0,0,0,0,
0,0,0,0,10,10,10,10,78,0,0,0,0,0,0,0,0,0,0,0,
0,0,0,0,10,10,0,0,0,0,0,0,0,0,0,0,0,0,0,0,
0,0,0,0,10,10,0,0,0,0,0,0,0,0,0,0,0,0,0,0,
0,0,0,0,0,0,0,0,0,0,0,0,0,0,0,0,0,0,0,0,
0,0,0,0,0,0,0,0,0,0,0,0,0,0,0,0,0,0,0,0,
0,0,0,0,0,0,0,0,0,0,0,0,0,0,0,0,0,0,0,0
0,0,0,0,0,0,0,0,0,0,0,0,0,0,0,0,0,0,0,0,
0,0,0,0,0,0,0,0,0,0,0,0,0,0,0,0,0,0,0,0,
0,0,0,0,0,0,0,0,0,0,0,0,0,0,0,0,0,0,0,0,
0,0,0,0,0,0,0,0,0,0,0,0,0,0,0,0,0,0,0,0,
0,0,0,0,0,0,0,0,0,0,0,0,0,0,0,0,0,0,0,0,
0,0,0,0,0,0,0,0,0,0,0,0,0,0,0,0,0,0,0,0,
0,0,0,0,0,0,0,0,0,0,0,0,0,0,0,0,0,0,0,0,
0,0,0,0,0,0,0,0,0,0,0,0,0,0,0,0,0,0,0,0,
0,0,0,0,0,0,0,0,0,0,0,0,0,0,0,0,0,0,0,0,
113,114,115,0,0,12,113,114,115,0,0,0,0,0,0,0,0,0,0,0,
121,122,123,113,114,115,121,122,123,0,0,0,0,0,0,0,0,0,0,0,
129,130,131,121,122,123,129,130,131,0,0,0,0,0,0,0,0,0,0,0,
0,0,0,129,130,131,0,0,0,0,0,0,0,0,0,0,0,0,0,0,
0,0,12,0,0,29,74,12,0,0,0,0,0,0,0,0,0,0,0,0,
0,0,0,0,12,0,74,74,0,0,0,0,0,0,0,0,0,0,0,0,
113,114,115,0,0,12,113,114,115,0,0,0,0,0,0,0,0,0,0,0,
121,122,123,0,0,12,121,122,123,0,0,0,0,0,0,0,0,0,0,0,
129,130,131,0,0,0,129,130,131,0,0,0,0,0,0,0,0,0,0,0,
0,0,0,0,0,0,0,0,0,0,0,0,0,0,0,0,0,0,0,0,
0,0,0,0,0,0,0,0,0,0,0,0,0,0,0,0,0,0,0,0