40
30
20
500
497,338,338,338,370,338,369,369,498,322,322,369,338,338,338,338,338,338,338,498,322,322,497,369,338,338,338,338,338,338,338,322,322,338,338,338,338,369,370,498,
338,338,338,338,338,370,401,401,402,322,322,338,338,338,338,338,338,338,338,402,322,322,337,369,338,338,338,338,338,338,338,322,322,338,338,338,338,401,402,370,
369,370,322,322,322,322,322,322,322,322,322,322,322,322,322,322,322,322,322,322,769,769,322,322,322,322,322,322,322,322,322,322,322,322,322,322,322,322,322,322,
401,402,322,402,401,402,401,401,402,322,322,401,338,338,322,338,338,322,401,402,322,322,337,322,370,369,370,322,370,369,370,322,322,402,401,402,401,322,401,402,
529,337,322,401,401,402,402,402,530,289,289,529,338,338,322,401,338,322,402,530,322,322,529,322,402,401,402,322,402,401,530,237,237,529,401,402,401,322,402,530,
0,0,434,0,0,0,433,0,0,289,289,0,0,0,433,0,0,433,0,0,322,322,0,433,0,0,0,433,0,0,0,237,237,0,0,0,0,433,0,0,
577,577,466,577,577,577,465,577,577,289,289,577,577,577,465,577,577,465,577,577,322,322,577,465,577,0,577,465,577,577,577,237,237,577,577,577,577,465,577,577,
577,577,577,577,577,577,577,577,577,577,577,577,577,577,577,577,577,577,577,577,577,577,577,577,577,577,577,577,577,577,577,577,577,577,577,577,577,577,577,577,
577,577,577,577,577,577,577,577,577,577,577,577,577,577,577,577,577,577,577,577,577,577,577,577,577,577,577,577,577,577,577,577,577,577,577,577,577,577,577,577,
577,577,577,577,577,577,577,577,577,577,577,577,577,577,577,577,577,577,577,577,577,577,577,577,577,577,577,577,577,577,577,577,577,577,577,577,577,577,577,577,
577,577,577,577,577,577,577,577,577,577,577,577,577,577,577,577,577,577,577,577,577,577,577,577,577,577,577,577,577,577,577,577,577,577,577,577,577,577,577,577,
577,577,577,577,577,577,577,577,577,577,577,577,577,577,577,577,577,577,577,577,577,577,577,577,577,577,577,577,577,577,577,577,577,577,577,577,577,577,577,577,
577,577,577,577,577,577,577,577,577,611,612,577,577,577,577,577,577,577,577,577,577,577,577,577,577,577,577,577,577,577,577,577,577,577,577,577,577,577,577,577,
577,577,577,577,577,577,577,577,577,643,644,577,577,577,577,577,577,577,577,577,577,577,577,577,577,577,577,577,577,577,577,577,577,577,577,577,577,577,577,577,
577,577,577,577,577,577,577,577,577,577,577,577,577,577,577,577,577,577,577,577,577,577,577,577,577,577,577,577,577,577,577,577,577,577,577,577,577,577,577,577,
577,577,577,577,577,577,577,577,577,577,577,577,577,577,577,577,577,577,577,323,323,323,323,577,577,577,577,577,577,577,577,577,577,577,577,577,577,577,577,577,
577,577,577,577,577,577,577,577,577,577,577,577,577,577,577,577,577,577,577,323,323,323,323,577,577,577,577,577,577,577,577,577,577,577,577,577,577,577,577,577,
577,577,577,577,577,577,577,577,577,577,577,577,577,577,577,577,577,577,577,323,323,323,323,577,577,577,577,577,577,577,577,577,577,577,577,577,577,577,577,577,
577,577,577,577,577,577,577,577,577,577,577,577,577,577,609,609,577,577,577,323,323,323,323,577,577,577,577,577,577,577,577,577,577,577,577,577,577,577,577,577,
577,577,577,577,577,577,577,577,577,577,577,577,577,577,609,609,577,577,577,577,577,577,577,577,577,577,577,577,577,577,577,577,577,577,577,577,577,577,577,577,
577,577,577,577,577,577,577,577,577,577,577,577,577,577,609,609,577,577,577,577,577,577,577,577,577,577,577,577,577,577,577,577,577,577,577,577,577,577,577,577,
577,577,577,577,577,577,577,577,577,577,577,577,577,577,609,609,577,577,577,577,577,577,577,577,577,577,577,577,577,577,577,577,577,577,577,577,577,577,577,577,
577,577,577,577,577,577,577,577,577,577,577,577,577,577,577,577,577,577,577,577,577,577,577,577,577,577,577,577,577,577,577,577,577,577,577,577,577,577,577,577,
577,577,577,577,577,577,577,577,577,577,577,577,577,577,577,577,577,577,577,577,577,577,577,577,577,577,577,577,577,577,577,577,577,577,577,577,577,577,577,577,
577,577,577,577,577,577,577,577,577,577,577,577,577,577,577,577,577,577,577,577,577,577,577,577,577,577,577,577,577,577,577,577,577,577,577,577,577,577,577,577,
577,577,577,577,577,577,577,577,577,577,577,577,577,577,577,577,577,577,577,577,577,577,577,577,577,577,577,577,577,577,577,577,577,577,577,577,577,577,577,577,
577,577,577,577,577,577,577,577,577,577,577,577,577,577,577,577,577,577,577,577,577,577,577,577,577,577,577,577,577,577,577,577,577,577,577,577,577,577,577,577,
577,577,577,577,577,577,577,577,577,577,577,577,577,577,577,577,577,577,577,577,577,577,577,577,577,577,577,577,577,577,577,577,577,577,577,577,577,577,577,577,
577,577,577,577,577,577,577,577,577,577,577,577,577,577,577,577,577,577,577,577,577,577,577,577,577,577,577,577,577,577,577,577,577,577,577,577,577,577,577,577,
577,577,577,577,577,577,577,577,577,577,577,577,577,577,577,577,577,577,577,577,577,577,577,577,577,577,577,577,577,577,577,577,577,577,577,577,577,577,577,577
0,0,0,0,0,0,0,0,0,0,0,0,0,0,0,0,0,0,0,0,0,0,0,0,0,0,0,0,0,0,0,0,0,0,0,0,0,0,0,0,
0,0,0,0,0,0,0,0,0,0,0,0,0,0,0,0,0,0,0,0,0,0,0,0,0,0,0,0,0,0,0,0,0,0,0,0,0,0,0,0,
0,0,0,0,0,0,0,0,0,0,0,0,0,0,0,0,0,0,0,0,0,0,0,0,0,0,0,0,0,0,0,0,0,0,0,0,0,0,0,0,
1743,0,0,0,0,0,0,0,1743,0,0,1743,0,0,0,0,0,0,1908,1743,0,0,1743,1908,0,0,0,0,0,0,1743,0,0,1743,0,0,0,0,0,1743,
1775,0,0,0,1807,0,0,0,1775,0,0,1775,0,0,0,1807,0,0,1940,1775,0,0,1775,1940,0,0,1807,0,0,0,1775,0,0,1775,0,0,0,0,0,1775,
561,433,0,433,433,433,0,434,562,0,0,561,433,433,0,433,433,0,433,562,0,0,561,0,434,433,434,0,434,433,562,0,0,561,433,434,433,0,434,562,
593,465,0,465,465,465,0,465,594,0,0,593,465,433,0,465,465,0,465,594,0,0,593,0,466,465,466,0,466,465,594,0,0,593,465,466,465,0,466,594,
0,0,0,0,0,0,0,0,0,0,0,0,0,0,0,0,0,0,0,0,0,0,0,0,0,0,0,0,0,0,0,0,0,0,0,0,0,0,0,0,
0,0,0,0,0,0,0,0,0,0,0,0,0,0,0,0,0,0,0,0,0,0,0,0,0,0,0,0,0,0,1889,0,0,0,0,0,0,0,0,0,
0,0,0,0,0,0,0,1793,0,0,0,0,0,1125,0,0,0,0,0,0,0,0,0,0,0,0,0,0,0,0,1921,0,0,0,0,0,0,0,0,0,
0,0,0,0,0,0,0,0,0,0,0,0,0,1157,0,0,0,0,0,0,0,0,0,0,0,0,0,0,0,0,0,0,0,0,0,0,0,0,0,1125,
0,0,0,0,0,0,0,0,0,0,0,0,0,0,0,0,0,0,0,0,0,0,0,0,0,0,0,1127,0,0,0,0,0,0,0,0,0,0,0,1157,
0,0,0,0,1125,0,0,0,0,0,0,0,0,0,0,1127,0,0,0,1125,0,0,0,0,0,0,0,0,0,0,0,1125,0,0,0,0,0,0,0,0,
0,0,0,0,1157,0,0,0,0,0,0,0,0,0,0,0,0,0,0,1157,0,0,0,0,0,0,0,0,0,0,0,1157,0,0,0,0,0,0,0,0,
0,0,0,0,0,0,0,0,0,0,0,0,0,1032,0,0,0,0,0,0,0,0,0,0,0,0,0,0,0,0,0,0,0,0,0,0,0,0,0,0,
0,0,0,0,0,0,0,0,0,0,0,1127,0,0,0,1159,0,0,1598,0,1539,1540,0,1635,0,0,0,0,0,0,0,0,0,0,0,0,0,0,0,0,
0,0,0,0,1121,0,0,0,0,0,0,0,0,0,0,0,0,0,1633,0,1571,1572,0,1667,0,0,0,0,0,0,0,1064,0,0,0,0,0,0,1127,0,
0,0,0,0,1153,0,0,0,0,0,0,0,0,0,0,0,0,0,1665,0,1603,1604,0,0,0,1159,0,0,0,1125,0,0,0,0,0,0,0,0,0,0,
0,0,0,0,0,0,0,0,0,0,0,0,0,0,0,0,0,0,1697,0,0,1547,0,0,0,1307,0,0,0,1157,0,0,0,0,0,0,0,0,0,0,
0,0,0,0,0,1127,0,0,0,0,0,1580,1581,0,0,0,0,0,0,0,1698,1699,0,0,0,0,0,0,0,0,0,0,0,0,0,0,0,0,0,0,
0,0,0,0,0,0,0,0,0,0,0,1612,1613,0,0,0,0,0,0,0,0,0,0,1742,0,0,0,0,0,0,0,0,0,0,0,0,0,0,0,0,
0,0,0,0,0,0,0,0,0,1125,0,0,0,0,0,0,0,0,0,0,0,0,0,1774,0,0,0,0,0,0,0,0,0,0,0,1640,0,0,0,0,
0,0,0,0,0,0,0,0,0,1157,0,0,0,0,0,0,0,0,0,0,0,0,0,0,0,0,0,0,0,0,0,0,0,0,0,0,0,0,0,0,
0,0,0,0,0,1159,0,1377,0,0,0,0,0,0,0,0,0,0,0,0,0,0,0,0,0,0,1127,0,0,0,1127,0,0,1159,0,0,0,0,0,1125,
0,0,0,0,0,0,0,0,0,0,0,0,0,0,0,0,0,0,0,0,0,0,0,0,0,0,0,0,0,0,0,0,0,0,0,0,0,0,0,1157,
0,0,0,0,0,0,0,0,0,0,0,0,0,0,0,0,1061,0,0,1125,0,0,0,0,0,0,0,0,0,0,0,0,0,0,0,0,0,0,0,0,
0,0,0,0,0,0,0,0,0,0,0,0,0,0,0,0,0,0,0,1157,577,577,577,577,577,577,577,0,0,0,0,0,0,0,0,0,0,0,0,0,
0,0,0,0,0,0,0,0,0,0,0,0,0,0,0,0,0,0,0,577,1636,1637,1636,1637,1636,1637,1636,1637,0,0,0,0,0,0,0,0,0,0,0,0,
0,0,0,0,1127,0,0,0,0,0,1512,0,0,0,0,0,0,0,0,577,1668,1669,1668,1669,1668,1669,1668,1669,0,0,0,0,0,0,0,1765,0,0,0,999,
0,0,0,0,0,0,0,0,0,0,0,0,0,0,0,0,0,0,0,0,1700,1701,1700,1701,1700,1701,1700,1701,0,0,0,0,0,0,0,0,0,0,0,0
0,0,0,0,998,0,1929,0,0,0,0,0,0,0,0,0,0,0,0,748,0,0,752,0,0,0,0,0,0,0,0,0,0,0,0,0,0,0,0,0,
0,0,0,0,0,0,1961,997,0,1285,0,0,0,0,0,0,0,0,0,780,781,783,784,0,0,0,0,0,0,0,0,0,0,0,0,0,0,0,0,0,
0,0,0,0,0,0,1961,0,0,0,0,0,0,0,0,0,0,0,0,812,813,815,816,0,0,0,0,0,0,0,0,0,0,0,0,0,0,0,0,0,
0,0,0,0,0,0,1961,0,0,0,0,0,0,0,0,0,0,0,0,0,845,847,0,0,0,0,1317,0,0,0,0,0,0,0,0,0,0,0,0,0,
0,0,0,0,0,0,1961,0,0,0,0,0,0,0,0,0,0,0,0,0,804,804,0,0,0,0,0,0,0,0,0,0,0,0,0,0,0,0,0,0,
0,0,878,0,0,0,878,0,0,0,0,0,1286,0,878,0,0,878,1282,0,0,0,0,878,1676,1677,1678,878,0,1410,0,0,0,0,0,1287,0,878,0,0,
0,0,910,0,0,0,910,0,0,0,0,0,1318,0,910,0,0,910,1314,0,0,0,0,910,1708,1709,1710,910,0,0,0,0,0,0,0,1319,0,910,0,0,
0,0,942,0,0,0,942,0,0,0,0,0,0,0,942,0,0,942,0,0,0,0,0,942,0,0,0,942,0,0,0,0,0,0,0,0,0,942,0,0,
0,0,0,0,0,0,1961,0,0,0,0,0,0,0,0,0,0,0,0,0,0,0,0,0,0,0,0,0,0,0,0,0,0,0,0,0,0,0,0,0,
0,0,0,0,0,0,1961,0,0,0,0,0,0,0,0,0,0,0,0,0,0,1128,0,0,0,0,0,0,0,0,1128,0,0,0,0,0,0,0,0,0,
0,0,0,0,0,0,1961,0,0,0,0,0,0,0,0,0,0,0,0,0,0,0,0,0,0,0,0,0,0,0,0,0,0,0,0,0,0,0,0,0,
0,0,0,0,0,0,1961,0,0,0,0,0,0,0,0,0,0,0,0,0,0,0,0,0,0,0,0,0,0,0,0,0,0,0,0,0,0,0,0,0,
0,0,0,0,0,0,1961,1128,0,0,0,0,0,0,0,0,0,0,0,0,0,0,0,0,0,0,0,0,0,0,0,0,0,0,0,0,0,0,0,0,
0,0,0,0,0,0,1961,0,0,0,0,0,0,0,0,0,0,0,0,0,0,0,0,0,0,0,1441,1442,0,0,0,0,0,0,0,421,422,0,0,0,
0,0,0,0,0,0,1961,0,0,0,0,0,0,0,0,0,0,0,0,0,0,0,0,0,0,0,1473,1474,0,0,0,0,0,0,0,453,454,0,0,0,
0,0,0,0,0,0,1961,0,0,0,0,0,0,0,0,0,0,0,0,0,0,0,0,0,0,0,0,0,0,0,0,0,0,0,0,0,0,0,0,0,
0,0,0,0,0,0,1961,0,0,0,0,0,0,0,0,0,0,0,0,0,0,0,0,0,0,0,0,0,0,0,0,0,0,0,0,0,0,0,0,0,
0,0,0,0,0,0,1961,0,0,0,0,0,1285,0,0,0,0,0,0,0,0,0,1936,0,0,1825,0,0,0,0,0,0,0,0,0,0,0,0,0,0,
0,0,0,0,0,0,1961,0,0,0,0,0,0,0,0,0,0,0,0,0,0,0,0,0,0,0,0,993,0,0,0,0,0,0,0,0,0,0,0,0,
0,0,0,0,0,0,1961,0,0,0,0,0,0,0,0,0,0,0,0,0,0,0,0,0,0,0,0,0,1963,1931,1931,1931,1931,1931,1931,1931,1931,1931,1931,1931,
0,0,0,0,0,0,1961,0,0,0,0,0,0,0,0,0,0,1128,0,0,1763,0,0,0,0,0,0,0,1961,0,0,0,0,0,0,0,0,0,0,0,
0,0,0,0,0,0,1961,0,0,0,0,0,0,0,0,0,0,0,1550,1551,1551,1551,1552,0,0,0,0,0,1961,0,0,0,0,0,0,0,0,0,0,0,
0,0,0,0,0,0,1961,0,0,0,0,0,0,0,0,0,0,0,0,0,0,0,0,0,0,0,0,0,1961,0,0,0,0,0,0,0,0,0,0,0,
0,0,0,0,0,0,1961,0,0,0,0,0,0,0,0,0,0,0,0,0,0,0,0,0,0,0,0,0,1961,0,0,0,0,0,0,0,0,0,0,0,
1931,1931,1931,1931,1931,1931,1998,1931,1931,1931,1931,1931,1931,1931,1931,1931,1931,1931,1931,1931,1931,1931,1931,1931,1931,1931,1931,1931,2000,1377,0,0,0,0,0,0,0,0,0,0,
0,0,0,0,0,0,0,0,0,0,0,0,0,0,0,0,0,0,0,0,0,0,0,1381,0,0,0,0,1961,0,0,0,0,0,0,0,0,0,0,0,
0,0,0,0,0,0,1128,0,0,0,0,0,0,0,0,0,0,0,0,1636,1637,1636,1637,1636,1637,1636,1637,0,1961,0,0,0,0,0,0,0,0,0,0,0,
0,0,0,0,0,0,0,0,0,0,0,0,0,0,0,0,0,0,0,1668,1669,1668,1669,1668,1669,1668,1669,0,1961,0,0,0,1128,0,0,0,0,0,0,0,
0,0,0,0,0,0,0,0,0,0,0,0,0,0,0,0,0,0,0,1700,1701,1700,1701,1700,1701,1700,1701,0,1961,0,0,0,0,0,0,0,0,0,0,0,
0,0,0,0,0,0,0,0,0,0,0,0,0,0,0,0,0,0,0,0,0,0,0,0,0,0,0,0,1961,0,0,0,0,0,0,0,0,0,0,0
