40
30
20
500
577,577,577,577,577,577,577,577,577,577,577,577,577,577,577,577,577,577,577,577,577,577,577,451,451,207,207,207,207,207,207,207,207,207,207,207,207,207,207,207,
577,577,577,577,577,577,577,577,577,577,577,577,577,577,577,577,577,577,577,577,577,577,577,451,207,207,207,207,207,207,207,207,207,207,207,207,207,207,207,207,
577,577,577,577,577,577,577,577,577,577,577,577,577,577,577,577,577,577,577,577,577,577,451,451,207,207,207,207,207,207,207,207,207,207,207,207,207,207,207,207,
577,577,577,577,577,577,577,577,577,577,577,577,577,577,577,577,577,577,577,577,451,451,451,207,207,207,207,207,207,207,207,207,207,207,207,207,207,207,207,207,
577,577,577,577,577,577,577,577,577,577,577,577,577,577,577,577,577,577,577,451,451,207,207,207,207,207,207,207,207,207,207,207,207,207,207,207,207,207,207,207,
577,577,577,577,577,577,577,577,577,577,577,577,577,577,577,577,577,577,451,451,207,207,207,207,207,207,207,207,207,207,207,207,207,207,207,207,207,207,207,207,
577,577,577,577,577,577,577,577,577,577,577,577,577,577,577,577,577,451,451,207,207,207,207,207,207,207,207,207,207,207,207,207,207,207,207,207,207,207,207,207,
577,577,577,577,577,577,577,577,577,577,577,577,577,577,577,577,577,451,207,207,207,207,207,207,207,207,207,207,207,207,207,207,207,207,207,207,207,207,207,207,
577,577,577,577,577,577,577,577,577,577,577,577,577,577,577,577,577,451,207,207,207,207,207,207,207,207,207,207,207,207,207,207,207,207,207,207,207,207,207,207,
577,577,577,577,577,577,577,577,577,577,577,577,577,577,577,577,577,451,207,207,207,207,207,207,207,207,207,207,207,207,207,207,207,207,207,207,207,207,207,207,
577,577,577,577,577,577,577,577,577,577,577,577,577,577,577,577,451,451,207,207,207,207,207,207,207,207,207,207,207,207,207,207,207,207,207,207,207,207,207,207,
577,577,577,577,417,418,577,577,577,577,577,577,577,577,577,577,451,207,207,207,207,207,207,207,207,207,207,207,207,207,207,207,207,207,207,207,207,207,207,207,
577,577,577,577,417,418,577,577,577,577,577,577,577,577,577,451,451,207,207,207,207,207,207,207,207,207,207,207,207,207,207,207,207,207,207,207,207,207,207,207,
577,577,577,577,417,418,577,577,577,577,577,577,577,577,451,451,207,207,207,207,207,207,207,207,207,207,207,207,207,207,207,207,207,207,207,207,207,207,207,207,
577,577,577,577,450,450,577,577,577,577,577,577,577,451,451,207,207,207,207,207,207,207,207,207,207,207,207,207,207,207,207,207,207,207,207,207,207,207,207,207,
577,577,577,577,417,417,577,577,577,577,577,577,451,451,207,207,207,207,207,207,207,207,207,207,207,207,207,207,207,207,207,207,207,207,207,207,207,207,207,207,
577,577,577,577,418,418,577,577,577,577,577,451,451,207,207,207,207,207,207,207,207,207,207,207,207,207,207,207,207,207,207,207,207,207,207,207,207,207,207,207,
577,577,577,577,449,449,577,577,577,577,577,451,207,207,207,207,207,207,207,207,207,207,207,207,207,207,207,207,207,207,207,207,207,207,207,207,207,207,207,207,
577,577,577,577,577,577,577,577,577,577,451,451,207,207,207,207,207,207,207,207,207,207,207,207,207,207,207,207,207,207,207,207,207,207,207,207,207,207,207,207,
577,577,577,577,577,577,577,577,577,577,451,207,207,207,207,207,207,207,207,207,207,207,207,207,207,207,207,207,207,207,207,207,207,207,207,207,207,207,207,207,
577,577,577,577,577,577,577,577,577,577,451,207,207,207,207,207,207,207,207,207,207,207,207,207,207,207,207,207,207,207,207,207,207,207,207,207,207,207,207,207,
577,577,577,577,577,577,577,577,577,451,451,207,207,207,207,207,207,207,207,207,207,207,207,207,207,207,207,207,207,207,207,207,207,207,207,207,207,207,207,207,
577,577,577,577,417,417,577,577,577,577,577,577,577,577,577,577,577,577,577,577,577,577,577,577,577,577,577,577,577,577,577,577,577,577,577,577,577,577,577,577,
577,577,577,577,417,418,577,577,577,577,577,577,577,577,577,577,577,577,577,577,577,577,577,577,577,577,577,577,577,577,577,577,577,577,577,577,577,577,577,577,
577,577,577,577,417,418,577,577,577,577,577,577,577,577,577,577,577,577,577,577,577,577,577,577,577,577,577,577,577,577,577,577,577,577,577,577,577,577,577,577,
577,577,577,577,450,450,577,577,577,577,577,577,577,577,577,577,577,577,577,577,577,577,577,73,73,73,73,73,73,73,73,73,73,73,73,73,73,73,73,73,
577,577,577,577,418,418,577,577,577,577,577,577,577,577,73,73,73,73,73,73,73,73,73,73,73,73,73,73,73,73,73,73,73,73,73,73,73,73,73,73,
577,577,577,577,418,418,577,577,577,577,577,73,73,73,73,73,73,73,73,73,73,73,73,73,73,73,73,73,73,73,73,73,73,73,73,73,73,73,73,73,
577,577,577,577,449,449,577,577,73,73,73,73,73,73,73,73,73,73,73,73,73,73,73,73,73,73,73,73,73,73,73,73,73,73,73,73,73,73,73,73,
577,577,577,577,577,577,73,73,73,73,73,73,73,73,73,73,73,73,73,73,73,73,73,73,73,73,73,73,73,73,73,73,73,73,73,73,73,73,73,73
338,338,338,338,338,338,498,0,0,0,0,0,0,0,0,0,0,0,0,0,0,0,0,0,0,1771,0,0,0,0,0,0,0,0,0,0,0,0,0,0,
338,338,338,338,338,1127,370,0,0,0,0,0,0,0,0,0,0,0,0,0,0,1061,0,0,1739,0,0,0,0,0,0,0,0,0,0,0,0,0,0,0,
338,338,338,338,338,338,402,0,0,0,0,0,0,0,0,0,0,0,0,0,0,0,0,0,1771,0,0,0,1803,0,0,0,0,0,0,1803,0,0,0,0,
338,338,338,338,338,338,370,0,0,0,0,1127,0,0,0,0,0,0,0,0,0,1739,0,0,0,0,0,0,0,0,0,0,0,0,0,0,0,0,0,0,
401,338,338,338,1127,338,530,0,0,0,0,0,0,0,0,0,0,0,0,0,0,1771,0,0,0,0,0,0,0,0,0,0,0,0,0,0,0,0,0,0,
433,433,433,433,433,433,562,0,0,0,0,0,0,0,0,0,0,0,0,1739,0,0,0,0,0,0,0,1803,0,0,0,0,0,1803,0,0,0,0,0,0,
465,465,465,465,465,465,594,0,0,0,0,0,0,0,0,0,0,0,0,1771,0,0,0,0,0,0,0,0,0,0,0,0,0,0,0,0,0,0,0,0,
0,0,0,0,0,0,0,0,0,0,0,0,0,0,0,0,0,0,0,0,0,0,0,0,0,0,0,0,0,0,0,0,0,0,0,0,0,0,0,0,
0,0,0,1127,0,0,0,0,0,0,0,0,0,0,0,0,0,0,1739,0,0,0,0,0,1803,0,0,0,0,0,0,0,1803,0,0,0,0,0,0,0,
0,0,0,0,0,0,0,0,0,0,0,0,0,0,0,0,1061,0,1771,0,0,0,0,0,0,0,0,0,0,0,0,0,0,0,0,0,0,1803,0,0,
0,0,0,0,0,0,0,0,0,0,0,0,0,0,0,0,0,0,0,0,0,0,1803,0,0,0,0,0,0,0,223,224,223,224,0,0,0,0,0,0,
0,0,0,0,0,0,0,0,0,0,0,0,0,0,0,0,0,1739,0,0,0,0,0,0,1840,0,0,0,0,0,255,256,255,256,0,0,0,0,0,0,
0,0,0,0,0,0,0,0,0,0,0,0,0,0,0,0,0,1771,0,0,0,0,0,0,1872,0,0,0,1884,0,287,288,287,288,0,1884,0,0,0,0,
0,0,0,0,0,0,0,0,0,0,0,0,0,0,0,1739,0,0,0,0,0,0,0,0,1904,0,0,0,1916,0,319,320,319,320,0,1916,0,0,1803,0,
0,0,0,0,0,0,0,0,0,0,0,0,0,0,0,1771,0,0,0,1803,0,0,0,0,0,0,0,0,0,1803,0,0,0,0,1803,0,0,0,0,0,
0,0,0,0,0,0,0,0,0,0,0,0,0,1739,0,0,0,0,0,0,0,0,0,1743,0,1743,1743,0,0,0,0,0,0,0,0,0,0,0,0,0,
0,0,0,0,0,0,0,0,0,0,1061,0,0,1771,0,0,0,0,0,0,0,0,0,1775,0,1775,1775,0,0,0,0,0,0,0,0,0,0,0,1835,0,
0,0,0,0,0,0,0,0,0,0,0,0,1739,0,0,0,1803,0,0,0,0,0,0,0,0,0,0,0,0,0,0,0,0,0,0,0,0,0,0,0,
0,0,0,0,0,0,0,1377,0,0,0,0,1771,0,0,0,0,0,0,0,0,0,0,0,0,0,0,0,0,0,0,0,0,0,0,0,0,0,0,0,
0,0,0,0,0,0,0,0,0,0,0,0,0,0,0,0,0,0,0,0,0,0,0,0,0,0,0,0,0,0,0,0,0,0,0,0,0,0,0,0,
0,0,0,0,0,0,0,0,0,0,0,1803,0,0,0,0,0,0,0,0,0,0,0,0,0,0,0,0,0,0,1979,1980,0,0,0,0,0,0,0,0,
0,0,0,0,0,0,0,0,0,0,0,1865,1868,1868,1868,1868,1869,1869,1869,1869,1868,1868,1868,1869,1868,1869,1869,1868,1869,1869,1868,1869,1868,1869,1869,1869,1869,1868,1867,1868,
0,1127,0,0,0,0,0,0,0,0,0,1897,1900,1900,1900,1900,1901,1901,1901,1901,1900,1900,1900,1901,1900,1901,1901,1900,1901,1901,1900,1901,1900,1901,1901,1901,1901,1900,1899,1900,
0,0,0,0,0,0,0,0,0,0,0,0,0,0,0,0,0,0,0,0,0,0,0,0,0,0,0,0,0,0,0,0,0,0,0,0,0,0,0,0,
0,0,0,0,0,0,0,0,0,0,0,0,0,0,0,0,0,0,0,0,0,0,0,0,0,0,0,0,0,0,0,0,0,0,0,0,0,0,0,0,
0,0,0,0,0,0,0,0,0,0,0,0,0,0,0,0,0,0,0,0,0,0,0,0,0,0,0,0,0,0,0,0,0,0,0,0,0,0,0,0,
0,0,0,0,0,0,0,0,0,0,0,0,0,0,0,0,0,0,0,0,0,0,0,0,0,0,0,0,0,0,0,0,0,0,0,0,0,0,0,0,
0,0,0,0,0,0,0,0,0,0,0,0,0,0,0,0,0,0,0,0,0,0,0,0,0,0,0,0,0,0,0,0,0,0,0,0,0,0,0,0,
1128,0,0,0,0,0,0,0,0,0,0,0,0,0,0,0,0,0,0,0,0,0,0,0,0,0,0,0,0,0,0,0,0,0,0,0,0,0,0,0,
0,0,0,0,0,0,0,0,0,0,0,0,0,0,0,0,0,0,0,0,0,0,0,0,0,0,0,0,0,0,0,0,0,0,0,0,0,0,0,0
0,0,0,0,0,0,0,0,1961,0,0,0,0,0,0,1734,1734,1734,1160,0,0,0,0,0,0,0,0,0,0,0,0,0,0,0,0,0,0,0,0,0,
0,0,0,0,0,0,0,0,1961,0,0,0,1128,0,1734,1734,1734,1734,0,0,0,0,0,0,0,0,0,0,0,0,0,0,0,0,0,0,0,0,0,0,
0,0,0,0,0,0,0,0,1961,0,1128,0,0,0,1734,1734,1734,0,0,0,0,0,0,0,0,0,0,0,0,0,0,0,0,0,0,0,0,0,0,0,
0,0,0,0,0,0,0,0,1961,0,0,0,0,1734,1734,1734,1734,0,0,0,0,0,0,0,0,0,0,0,0,0,0,0,0,0,0,0,0,0,0,0,
0,0,0,0,0,0,0,0,1961,0,0,0,0,1734,1734,1734,0,0,0,0,0,0,0,0,0,0,0,0,0,0,0,0,0,0,0,0,0,0,0,0,
0,0,0,0,0,0,0,0,1961,0,0,0,1734,1734,1734,1734,0,0,0,0,0,0,0,0,0,0,0,0,0,0,0,0,0,0,0,0,1285,0,0,0,
0,0,0,0,0,0,0,0,1961,1160,0,0,1734,1734,1734,0,1160,0,0,0,0,0,0,0,0,0,0,0,0,0,0,0,0,0,0,0,1317,0,0,0,
0,0,0,0,0,0,0,0,1961,0,0,0,1734,1734,0,0,0,0,0,0,0,0,0,0,0,0,0,0,0,0,0,0,0,0,0,0,0,0,0,0,
0,0,0,0,0,0,1128,1128,1961,0,0,1734,1734,0,0,0,0,0,0,0,0,0,0,0,0,0,0,0,0,1285,0,0,0,0,0,0,0,0,0,0,
0,1766,0,0,0,0,0,0,1961,0,0,1734,0,0,0,0,0,0,0,0,0,0,0,0,0,0,0,0,0,1317,0,0,0,0,0,0,0,0,0,0,
0,0,0,0,1128,0,0,0,1961,0,1734,1734,0,0,0,0,0,0,0,0,0,0,0,0,0,0,0,0,0,0,0,0,0,0,0,0,0,0,0,0,
0,0,0,0,0,0,0,0,1961,0,1734,1734,1160,0,0,0,0,0,0,0,0,0,0,0,0,0,0,0,0,0,0,0,0,0,0,0,0,0,0,0,
0,0,0,0,0,0,0,0,1961,0,1734,0,0,0,0,0,0,0,0,0,0,0,0,0,1905,0,0,0,0,0,0,1784,1784,0,0,0,0,0,0,0,
0,0,1128,0,0,0,0,0,1961,0,0,0,0,0,0,0,0,0,0,0,0,0,0,0,0,0,0,0,0,0,0,1753,1754,0,0,0,0,0,0,0,
0,0,0,0,0,0,0,0,1961,0,0,0,0,0,0,0,0,0,0,0,0,0,0,0,0,0,0,0,0,0,0,0,0,0,0,0,0,0,0,0,
0,0,0,0,0,0,0,0,1961,0,0,0,0,0,0,0,0,0,0,0,0,0,0,1746,0,1747,1748,0,0,0,0,0,0,0,0,0,0,0,0,0,
0,0,0,0,0,0,0,0,1961,0,0,0,0,0,0,0,0,0,0,0,0,0,0,1778,0,1779,1780,0,0,0,0,0,0,0,0,0,0,0,0,0,
0,0,0,0,0,0,0,0,1961,0,0,0,0,0,0,0,0,0,0,0,0,0,0,0,0,0,0,0,0,0,0,0,0,0,0,0,0,0,0,0,
0,0,0,0,0,0,0,0,1961,0,0,0,0,0,0,0,0,0,0,0,0,0,0,0,0,0,0,0,0,0,0,0,0,0,0,0,0,0,0,0,
1931,1931,1931,1931,1931,1931,1931,1931,1998,1931,1931,1931,1931,1931,1931,1931,1931,1931,1931,1931,1931,1931,1931,1931,1931,1931,1931,1931,1931,1931,1931,1931,1931,1931,1931,1931,1931,1931,1931,1931,
0,0,0,0,0,0,0,0,0,0,0,0,0,0,0,0,0,0,0,0,0,0,0,0,0,0,0,0,0,0,0,0,0,0,0,0,0,0,0,0,
0,0,0,0,0,0,0,0,0,0,0,0,0,0,0,0,0,0,0,0,0,0,0,0,0,0,1285,0,0,0,0,0,0,0,0,0,0,0,0,0,
0,0,0,0,0,0,0,0,0,0,0,0,0,0,0,0,0,0,0,0,0,0,0,0,0,0,1317,0,0,0,0,0,0,0,0,0,0,0,0,0,
0,0,1128,0,0,0,0,0,0,0,0,0,0,0,0,0,0,0,0,0,0,0,0,0,0,0,0,0,0,0,0,0,0,0,0,0,0,0,0,0,
0,1128,0,0,0,0,0,0,0,0,0,0,0,0,0,0,0,0,0,0,0,0,0,0,0,0,0,0,0,0,0,0,0,0,0,0,0,0,0,0,
0,0,0,0,0,0,0,0,0,0,0,0,0,0,0,0,0,1285,0,0,0,0,0,0,0,0,0,0,0,0,0,0,0,1028,1285,0,0,0,0,0,
0,0,0,0,0,0,0,0,0,0,0,0,0,0,0,0,0,1317,0,0,0,0,0,0,0,0,0,1028,0,0,0,0,0,0,1317,0,1028,0,0,0,
0,0,0,0,0,0,0,0,0,0,0,0,0,0,0,0,0,0,0,0,0,0,0,0,1028,0,0,0,0,0,0,0,0,0,0,0,0,0,0,0,
0,0,0,0,0,0,0,0,0,0,0,0,0,0,0,0,0,0,0,0,1026,0,0,0,0,1026,0,0,0,0,1026,1026,0,0,1026,1026,0,0,0,0,
0,0,0,0,0,0,0,0,0,0,0,0,0,0,0,0,1026,0,0,0,0,0,0,0,0,0,0,0,0,0,0,0,1026,0,0,0,0,0,0,0
