40
30
20
500
2273,2273,2273,2273,2273,2273,2273,2273,2273,2273,2273,2273,2273,2273,2273,2273,2273,2273,2273,2273,2273,2273,2273,2273,2273,2273,2273,2273,2273,2273,2273,2273,2273,2273,2273,2273,2273,2273,2273,2273,
2305,2305,2305,2305,2305,2305,2305,2305,2305,2305,2305,2305,2305,2305,2305,2305,2305,2305,2305,2305,2305,2305,2305,2305,2305,2305,2305,2305,2305,2305,2305,2305,2305,2305,2305,2305,2305,2305,2305,2305,
2305,2305,2305,2305,2305,2305,2305,2305,2305,2305,2305,2305,2305,2305,2305,2305,2305,2305,2305,2305,2305,2305,2305,2305,2305,2305,2305,2305,2305,2305,2305,2305,2305,2305,2305,2305,2305,2305,2305,2305,
2337,2337,2337,2337,2337,2337,2337,2337,2337,2337,2337,2337,2337,2337,2337,2337,2337,2337,2337,2337,2337,2337,2337,2337,2337,2337,2337,2337,2337,2337,2337,2337,2337,2337,2337,2337,2337,2337,2337,2337,
2337,2337,2337,2337,2337,2337,2337,2337,2337,2337,2337,2337,2337,2337,2337,2337,2337,2337,2337,2337,2337,2337,2337,2337,2337,2337,2337,2337,2337,2337,2337,2337,2337,2337,2337,2337,2337,2337,2337,2337,
2369,2369,2369,2369,2369,2369,2369,2369,2369,2369,2369,2369,2369,2369,2369,2369,2369,2369,2369,2369,2369,2369,2369,2369,2369,2369,2369,2369,2369,2369,2369,2369,2369,2369,2369,2369,2369,2369,2369,2369,
497,338,338,338,338,338,338,338,338,338,338,338,338,338,338,338,338,338,338,338,338,338,338,338,338,338,338,338,338,338,338,338,338,338,338,338,338,338,338,498,
338,338,338,338,338,338,338,338,338,338,338,338,338,338,338,338,338,338,338,338,338,338,338,338,338,338,338,338,338,338,338,338,338,338,338,338,338,338,338,338,
338,338,338,338,338,338,338,338,338,338,338,338,338,338,338,338,338,338,338,338,338,338,338,338,338,338,338,338,338,338,338,338,338,338,338,338,338,338,338,338,
529,338,338,338,338,338,338,338,338,338,338,338,338,338,338,338,338,338,338,338,338,338,338,338,338,338,338,338,338,338,338,338,338,338,338,338,338,338,338,530,
577,577,577,577,577,577,577,577,577,577,577,577,577,577,577,577,577,577,577,577,577,577,577,577,577,577,577,577,577,577,577,577,577,577,577,577,577,577,577,577,
577,577,577,577,577,577,577,577,577,577,577,577,577,577,577,577,577,577,577,577,577,577,577,577,434,434,577,577,577,577,577,577,577,577,577,577,577,577,577,577,
577,577,577,577,577,577,577,577,577,577,577,577,577,577,577,577,577,577,577,577,577,577,577,577,577,577,577,577,577,577,577,577,577,577,577,577,577,577,577,577,
577,577,577,577,577,577,577,577,577,577,577,577,577,577,577,577,577,577,577,577,577,577,577,577,577,577,577,577,577,577,577,577,577,577,577,577,577,577,577,577,
577,577,577,577,577,577,577,577,577,577,577,577,577,577,577,577,577,577,577,577,577,577,577,577,577,577,577,577,577,577,577,577,577,577,577,577,577,577,577,577,
577,577,577,577,577,577,577,577,577,577,577,577,577,577,577,577,577,577,577,577,577,577,577,577,577,577,577,577,577,577,577,577,577,577,577,577,577,577,577,577,
577,577,577,577,577,577,577,577,577,577,577,577,577,577,577,577,577,577,577,577,577,577,577,577,577,577,577,577,577,577,577,577,577,577,577,577,577,577,577,577,
577,577,577,577,577,577,577,577,577,577,577,577,577,577,577,577,577,577,577,577,577,577,577,577,577,577,577,577,577,577,577,577,577,577,577,577,577,577,577,577,
577,577,577,577,577,577,577,577,577,577,577,577,577,577,577,577,577,577,577,577,577,577,577,577,577,577,577,577,577,577,577,577,577,577,577,577,577,577,577,577,
577,577,577,577,577,577,577,577,577,577,577,577,577,577,577,577,577,577,577,577,577,577,577,577,577,577,577,577,577,577,577,577,577,577,577,577,577,577,577,577,
577,577,577,577,577,577,577,577,577,577,577,577,577,577,577,577,577,577,577,577,577,577,577,577,577,577,577,577,577,208,208,208,208,577,577,577,577,577,577,577,
577,577,577,577,577,577,577,577,577,577,577,577,577,577,577,577,577,577,577,577,577,577,577,577,577,577,577,577,577,208,208,208,208,577,577,577,577,577,577,577,
577,577,577,577,577,577,577,577,577,577,577,577,577,577,577,577,577,577,577,577,577,577,577,577,577,577,577,577,577,208,208,208,208,577,577,577,577,577,577,577,
577,577,577,577,577,577,577,577,577,577,577,577,577,577,577,577,577,577,577,577,577,577,577,577,577,577,577,577,577,774,208,208,774,577,577,577,577,577,577,577,
577,577,577,577,577,577,577,577,577,577,577,577,577,577,577,577,577,577,577,577,577,577,577,577,577,577,577,577,577,577,577,577,577,577,577,577,577,577,577,577,
577,577,577,577,577,577,577,577,577,577,577,577,577,577,577,577,577,577,577,577,577,577,577,577,577,577,577,577,577,577,577,577,577,577,577,577,577,577,577,577,
577,577,577,577,577,577,577,577,577,577,577,577,577,577,577,577,577,577,577,577,577,577,577,577,577,577,577,577,577,577,577,577,577,577,577,577,577,577,577,577,
577,577,577,577,577,577,577,577,577,577,577,577,577,577,577,577,577,577,577,577,577,577,577,577,577,577,577,577,577,577,577,577,577,577,577,577,577,577,577,577,
577,577,577,577,577,577,577,577,577,577,577,577,577,577,577,577,577,577,577,577,577,577,577,577,577,577,577,577,577,577,577,577,577,577,577,577,577,577,577,577,
577,577,577,577,577,577,577,577,577,577,577,577,577,577,577,577,577,577,577,577,577,577,577,577,577,577,577,577,577,577,577,577,577,577,577,577,577,577,577,577
0,0,0,0,0,0,0,0,0,0,0,0,0,0,0,0,0,0,0,0,0,0,0,0,0,0,0,0,0,0,0,0,0,0,0,0,0,0,0,0,
0,0,0,0,0,0,0,0,0,0,0,0,0,0,0,0,0,0,0,0,0,0,0,0,0,0,0,0,0,0,0,0,0,0,0,0,0,0,0,0,
0,0,0,0,0,0,0,0,0,0,0,0,0,0,0,0,0,0,0,0,0,0,0,0,0,0,0,0,0,0,0,0,0,0,0,0,0,0,0,0,
0,0,0,0,0,0,0,0,0,0,0,0,0,0,0,0,0,0,0,0,0,0,0,0,0,0,0,0,0,0,0,0,0,0,0,0,0,0,0,0,
0,787,788,787,788,788,0,0,0,787,787,787,787,788,0,0,0,787,787,787,787,788,0,0,0,787,787,787,787,788,0,0,0,787,787,787,787,788,0,0,
717,819,820,819,820,820,715,715,715,819,819,819,819,820,747,747,747,819,819,819,819,820,716,716,716,819,819,819,819,820,746,746,746,819,819,819,819,820,745,745,
0,851,852,851,852,852,0,1453,0,851,851,851,851,852,0,1451,0,851,851,851,851,852,1439,1453,0,851,851,851,851,852,0,1455,0,851,851,851,851,852,0,0,
0,883,884,883,884,884,0,1453,0,883,883,883,883,306,0,1451,0,883,883,883,883,884,1471,1453,0,883,883,883,883,884,0,1455,0,883,883,883,883,884,1566,0,
0,0,0,0,0,0,0,0,0,0,0,0,0,0,0,0,0,0,0,0,0,0,0,0,0,0,0,0,0,1696,0,0,0,0,0,0,0,1663,1241,1242,
1378,0,0,0,0,0,1307,1453,1378,0,0,0,0,0,1338,1451,1378,0,0,0,0,0,1275,1453,1378,0,0,0,0,0,1337,1455,1378,0,0,0,0,0,1273,1274,
561,433,433,0,433,433,433,433,433,433,433,0,433,433,433,433,433,433,434,0,434,434,434,434,433,433,433,0,433,433,433,433,433,433,433,0,433,433,433,562,
593,465,465,0,465,465,465,465,465,465,465,0,465,465,465,465,465,465,466,0,466,466,466,466,1941,1942,465,0,465,465,465,465,465,465,465,0,465,465,465,594,
0,0,0,0,0,1127,0,0,0,0,0,0,0,0,0,0,0,0,0,0,0,0,0,0,1973,1974,0,0,0,0,0,0,0,0,0,0,0,0,0,0,
0,0,0,0,1127,1127,0,0,0,0,0,0,0,0,0,0,0,0,0,0,0,0,0,0,0,0,0,0,0,1410,0,0,0,0,0,0,0,0,0,0,
0,0,0,1127,0,0,0,0,0,0,0,0,0,0,0,0,0,0,0,0,0,0,0,0,0,0,0,0,0,0,0,0,0,0,0,0,0,0,0,0,
0,0,1127,1127,0,0,0,0,0,0,1127,1127,1127,1127,1127,0,0,0,0,0,0,0,0,1860,0,0,1356,1358,1356,0,0,0,0,0,0,0,0,1127,1127,0,
0,0,0,0,0,1127,1127,0,0,1127,1127,0,0,0,0,0,0,0,0,0,0,0,0,1152,0,0,0,0,0,0,0,0,0,0,0,0,0,0,0,0,
0,0,0,0,0,0,0,0,0,0,0,0,0,1635,1635,0,0,0,0,0,0,0,0,998,1633,1550,0,0,0,1552,0,1271,1272,0,1127,0,0,0,0,0,
0,0,0,0,0,0,0,0,0,0,0,0,0,1667,1667,0,0,0,0,0,0,0,0,0,1665,0,0,0,0,0,1381,1127,0,0,0,0,0,0,0,0,
0,0,0,1125,0,953,954,1111,1112,0,0,0,0,1635,1635,1608,1603,1604,1548,0,0,0,0,0,1697,0,0,0,0,0,0,0,0,0,0,0,0,0,0,0,
0,0,497,338,498,985,986,1143,1144,0,0,0,0,1667,1667,0,0,0,0,0,0,0,0,0,0,0,0,1061,0,0,0,0,0,0,0,0,0,0,0,0,
0,0,529,338,530,0,0,0,0,0,0,0,0,1698,1699,0,0,0,0,0,0,0,0,0,0,0,0,0,0,0,0,0,0,1207,1207,0,0,0,0,0,
0,0,561,434,562,1894,0,0,0,0,0,0,0,0,0,0,0,0,0,0,0,0,0,0,0,0,0,1269,1269,0,0,0,0,1269,1269,0,0,0,0,0,
0,1894,593,466,594,0,0,0,0,0,0,0,0,0,0,0,0,0,0,0,2003,0,2003,0,0,0,0,0,0,648,0,0,648,0,0,0,0,0,0,0,
0,0,0,0,1574,0,0,0,0,0,0,0,0,0,0,0,0,0,0,0,0,0,0,0,0,0,0,0,0,0,0,0,0,0,0,0,0,0,0,0,
1911,1912,0,0,0,0,0,0,0,0,0,0,0,0,0,0,0,0,1414,0,0,1414,1414,1414,1380,1414,0,0,0,0,0,0,0,0,0,0,0,0,0,0,
1943,1944,0,0,0,0,0,0,0,0,0,0,0,0,0,0,0,0,1446,1414,1414,1446,1446,1446,1414,1446,1414,0,0,0,0,0,0,0,0,0,0,0,0,0,
0,0,0,0,0,0,0,0,0,0,0,0,0,1611,1611,1611,0,0,0,1446,1446,1414,1414,1414,1446,0,1446,0,0,0,0,1127,0,0,0,0,0,0,0,0,
0,0,0,1479,1480,0,0,0,0,0,0,0,0,1611,1611,1611,0,0,0,0,1414,1446,1446,1446,1414,0,0,0,0,0,0,1127,1127,0,0,0,0,0,0,0,
0,0,0,0,0,0,0,0,0,0,1127,1127,0,0,1611,0,0,0,0,0,1446,0,0,0,1446,0,0,0,0,0,0,0,0,0,0,0,0,0,0,0
2276,0,0,0,0,0,0,0,0,0,0,0,0,0,0,0,0,0,0,2277,0,0,0,0,0,0,0,0,0,0,0,0,0,0,0,0,0,0,0,0,
2308,0,0,0,0,0,2308,2309,2310,2311,0,0,2372,2373,2374,2375,0,0,2308,0,0,2309,0,0,0,0,0,2276,2277,2278,2279,2277,2278,2279,0,0,0,0,0,0,
2340,2341,2342,2343,0,0,0,0,0,0,0,0,0,0,0,0,0,0,0,0,2340,2341,2342,2343,0,0,0,0,0,0,0,0,0,0,0,0,0,0,0,0,
2372,2373,2374,0,0,0,0,0,0,0,2340,2341,2342,2343,0,0,2372,2372,2276,2277,2278,2279,2374,2375,0,2276,2277,2278,2279,0,0,0,0,0,0,2276,2277,2278,2279,0,
0,0,0,0,0,0,0,0,0,0,0,0,0,0,0,0,0,0,0,0,0,0,0,0,0,0,0,0,0,0,0,2276,2277,0,0,0,0,0,0,0,
0,0,0,706,0,0,0,0,0,0,0,708,0,0,0,0,0,0,0,743,0,0,0,0,0,0,0,738,0,0,0,0,0,0,0,740,0,0,0,0,
0,591,592,0,591,592,0,0,0,591,592,0,591,592,0,0,0,591,592,0,591,592,0,0,0,1750,673,841,673,1651,0,0,0,897,897,0,897,897,0,0,
0,623,624,686,623,624,0,0,0,655,656,686,655,656,0,0,0,687,688,686,687,688,0,0,0,1782,705,873,705,1664,0,0,0,898,930,654,930,898,0,0,
0,0,0,294,0,0,0,0,0,0,0,290,0,0,0,0,0,0,0,257,0,0,0,0,0,0,0,258,0,0,0,0,0,0,0,261,0,0,0,0,
1751,0,0,294,0,0,0,0,1751,0,0,290,0,0,0,0,1751,0,0,257,0,0,0,0,1751,0,0,258,0,0,0,0,1752,0,0,261,0,0,0,0,
0,0,0,294,0,0,0,0,1285,0,0,290,0,0,0,1673,0,0,0,257,0,0,0,0,0,0,0,258,0,1674,0,1286,0,879,1673,261,0,1675,0,0,
0,0,0,294,0,0,0,0,1317,0,0,290,0,0,0,1705,0,0,0,257,0,1320,0,0,0,0,0,258,0,1706,0,1318,0,911,1705,261,0,1707,0,0,
0,0,0,0,0,0,0,0,0,0,0,0,0,0,0,0,0,0,0,0,0,0,0,0,0,0,0,0,0,0,0,0,0,943,0,0,0,0,0,0,
0,0,0,0,0,0,0,0,0,0,0,0,0,0,0,0,0,0,0,0,0,0,0,0,0,0,0,0,0,0,0,0,0,0,0,0,0,0,0,0,
0,0,0,0,0,0,0,0,0,0,0,0,0,0,0,0,0,0,0,0,0,0,0,0,0,0,0,0,0,0,0,0,0,0,0,0,0,0,0,0,
0,0,0,0,0,0,0,0,0,0,0,0,0,0,0,0,0,0,0,0,0,0,1934,0,1937,0,0,0,0,0,0,0,0,0,0,0,0,0,0,0,
0,0,0,0,0,0,0,0,0,0,0,0,0,0,0,0,0,0,0,0,0,1929,0,0,0,0,0,1407,0,0,0,1239,1240,0,0,0,0,0,0,0,
0,0,0,0,0,0,0,0,0,0,0,0,0,0,0,0,1539,1540,0,0,0,1961,0,0,0,0,1582,1583,1584,0,0,0,0,0,0,0,0,0,0,0,
0,0,0,0,0,1316,1316,0,0,0,0,0,0,0,0,0,1571,1572,0,0,0,1961,0,0,0,0,0,0,0,0,0,0,0,0,0,0,0,0,0,0,
0,0,0,0,0,0,0,0,0,0,0,0,0,0,0,0,0,0,0,0,1732,1961,0,0,0,0,0,0,0,0,0,0,0,0,0,0,0,0,0,0,
0,0,0,1157,1894,0,0,0,0,0,0,1160,0,0,0,0,0,0,0,0,0,1961,0,0,0,0,0,0,0,552,551,551,552,1175,1175,0,0,0,0,0,
0,0,0,0,1926,0,0,0,0,0,0,0,0,0,0,0,0,0,0,1764,0,1961,0,0,0,0,0,1237,1237,584,583,583,584,1237,1237,0,0,0,0,0,
0,0,1676,1677,1678,0,0,0,0,0,0,0,0,0,0,0,0,0,0,0,1971,1961,1971,0,0,0,0,0,0,616,679,680,616,0,0,0,0,0,1160,0,
0,0,1708,1709,1710,0,0,0,0,0,0,0,0,0,0,0,0,0,0,0,0,1961,0,0,0,0,0,0,0,0,647,647,0,0,0,0,0,0,0,0,
0,0,0,1930,1931,1931,1931,1931,1931,1931,1931,1931,1931,1931,1931,1931,1931,1931,1931,1931,1931,1931,1931,1931,1931,1931,1931,1931,1931,1931,1931,1931,1931,1931,1931,1931,1931,1931,1931,1931,
0,0,0,0,0,1934,0,0,0,0,0,0,0,0,0,0,0,0,0,0,0,0,0,0,0,0,0,0,0,0,0,0,0,0,0,0,0,0,0,0,
0,0,0,0,0,0,0,0,0,0,0,0,0,0,0,0,0,0,0,0,0,0,0,0,0,0,0,0,0,0,0,0,0,0,0,0,0,0,0,0,
0,0,0,0,0,0,0,0,0,1160,0,0,0,0,0,0,0,0,0,0,0,0,0,0,0,0,0,0,0,0,0,0,0,0,0,0,0,0,0,0,
0,0,0,0,0,0,0,0,0,0,0,0,0,0,0,0,0,0,0,0,0,0,0,0,0,0,0,0,0,0,0,0,0,0,0,0,0,0,0,0,
0,0,0,0,0,0,0,0,0,0,0,0,0,0,0,0,0,0,0,0,0,0,1160,0,0,0,0,0,0,0,0,0,0,0,0,0,0,0,0,0
