40
30
500
20
578,578,578,578,578,578,578,578,578,578,578,578,578,578,578,578,578,578,578,578,578,578,578,578,578,578,578,578,578,578,578,578,578,578,578,578,578,578,578,578,
578,578,578,578,578,578,0,578,578,578,578,578,578,578,578,578,578,578,578,73,73,73,578,578,578,578,578,578,578,578,578,578,578,578,578,578,578,578,578,578,
578,578,578,578,0,578,0,0,578,0,578,578,578,578,578,578,578,578,578,578,578,73,73,73,73,578,578,578,578,578,578,578,578,578,578,578,578,578,578,578,
578,578,578,578,578,578,578,578,578,0,0,0,0,0,0,0,0,578,578,578,578,578,73,73,73,73,73,578,578,578,578,578,578,578,578,578,578,578,578,578,
578,578,578,578,578,578,578,578,578,578,578,0,0,0,0,0,0,0,0,0,578,578,578,73,73,73,73,73,578,73,73,578,578,578,578,578,578,578,578,578,
578,578,578,73,73,73,73,578,578,578,578,0,0,0,0,0,0,0,0,0,0,578,578,578,578,578,578,578,578,73,73,73,73,73,578,578,578,578,578,578,
578,73,73,73,73,73,73,73,578,578,578,578,0,0,0,0,0,0,0,0,0,0,0,578,578,578,578,578,578,578,578,578,73,73,73,73,578,578,578,578,
73,73,73,73,73,73,73,73,73,73,73,578,578,578,0,0,0,0,0,0,0,0,0,0,0,0,578,578,578,578,578,578,73,73,73,73,73,578,578,578,
73,73,73,73,73,73,73,73,73,73,73,73,73,578,578,578,578,578,0,0,0,0,0,0,0,0,0,0,770,578,578,578,578,578,73,73,73,73,578,578,
73,73,73,73,73,73,73,73,73,73,73,73,73,73,578,578,578,578,578,0,0,0,0,0,0,0,0,0,770,0,0,578,578,578,578,73,73,73,73,578,
73,73,73,73,73,73,73,73,73,73,73,73,73,73,73,73,578,578,578,578,0,0,0,0,0,0,0,0,770,0,0,0,578,578,578,73,73,73,73,73,
73,73,73,73,73,73,73,73,73,73,73,73,73,73,73,73,73,73,578,578,578,0,0,0,0,0,0,0,770,0,0,0,0,578,578,578,73,73,73,73,
73,73,73,73,73,73,73,73,73,73,73,73,73,73,73,73,73,73,578,578,578,578,0,0,0,0,0,0,770,0,0,0,0,0,578,578,578,578,73,73,
73,73,73,73,73,73,73,73,73,73,73,73,73,73,73,73,73,73,73,578,769,769,769,769,769,769,769,769,769,769,769,769,769,769,769,769,769,770,578,73,
73,73,73,73,73,73,73,73,73,73,73,73,73,73,73,73,73,73,73,73,73,578,578,578,0,0,0,0,0,0,0,0,0,0,0,578,578,770,578,73,
73,73,73,73,73,73,73,73,73,73,73,73,73,73,73,73,73,73,73,73,73,73,73,578,578,0,0,0,0,0,0,0,0,0,0,578,578,770,578,73,
73,73,73,577,577,577,577,73,577,577,577,577,73,73,73,73,73,73,73,73,73,73,73,578,578,578,0,0,0,0,0,0,0,0,0,0,578,770,578,73,
73,73,73,577,577,577,577,73,577,577,577,577,73,73,73,73,73,73,73,73,73,73,73,73,578,578,578,0,0,0,0,0,0,0,0,0,578,770,578,73,
73,73,73,73,73,73,73,73,73,73,73,73,73,73,73,73,73,73,73,73,73,73,73,73,578,578,578,0,0,0,0,0,0,0,0,0,578,770,73,73,
73,73,73,577,577,577,577,73,577,577,577,577,73,73,73,73,73,73,73,73,73,73,73,73,578,578,578,0,0,0,0,0,0,0,0,578,73,770,73,73,
73,73,73,577,577,577,577,73,577,577,577,577,73,73,73,73,73,73,73,73,73,73,73,578,578,578,0,0,0,0,0,0,0,0,0,578,73,770,73,73,
73,73,73,73,73,73,73,73,73,73,73,73,73,73,73,73,73,73,73,73,73,73,73,578,578,578,0,0,0,0,0,0,0,0,578,73,73,770,73,73,
73,73,73,73,73,73,73,73,73,73,73,73,73,73,73,73,73,73,73,73,73,73,578,578,578,0,0,0,0,0,0,0,0,0,578,73,73,770,73,73,
73,73,73,73,73,73,73,73,73,73,73,73,73,73,73,73,73,73,73,73,73,578,578,578,578,0,0,0,0,0,0,0,0,578,73,73,73,73,73,73,
73,73,73,73,73,73,73,73,73,73,73,73,73,73,73,73,73,73,73,73,578,578,578,578,0,0,0,0,0,0,0,0,578,578,73,73,73,73,73,73,
73,73,73,73,73,73,73,73,73,73,73,73,73,73,73,73,73,73,73,578,578,578,578,578,0,0,0,0,0,0,0,0,578,73,73,73,73,73,73,73,
73,73,73,73,73,73,73,73,73,73,73,73,73,73,73,73,73,73,73,578,578,578,578,0,0,0,0,0,0,0,0,578,578,73,73,73,73,73,73,73,
73,73,73,73,73,73,73,73,73,73,73,73,73,73,73,73,73,73,578,578,578,578,0,0,0,0,0,0,0,0,578,578,73,73,73,73,73,73,73,73,
73,73,73,73,73,73,73,73,73,73,73,73,73,73,73,73,73,578,578,578,578,0,0,0,0,0,0,0,0,578,578,578,73,73,73,73,73,73,73,73,
73,73,73,73,73,73,73,73,73,73,73,73,73,73,73,73,578,578,578,578,578,0,0,0,0,0,0,0,0,578,578,73,73,73,73,73,73,73,73,73
0,0,0,0,0,0,0,0,0,0,0,0,0,0,0,0,0,0,0,0,0,1700,1701,1700,1701,1668,1669,0,0,0,0,0,0,0,0,0,0,0,0,0,
0,0,0,0,0,0,2051,0,0,0,0,0,0,0,0,0,0,0,0,0,0,0,0,0,0,1700,1701,0,0,0,0,0,0,0,0,0,0,0,0,0,
0,0,0,0,2050,0,2083,2084,0,2050,0,0,0,0,0,0,0,0,0,0,0,0,0,0,0,0,0,0,0,0,0,0,0,0,0,0,0,0,0,0,
0,0,0,0,0,0,0,0,0,2082,2083,2115,2115,2118,2118,2118,2118,0,0,0,0,0,0,0,0,0,0,0,0,0,0,0,0,0,0,0,0,0,0,0,
0,0,0,0,0,0,0,0,0,0,0,2114,2115,2115,2115,2116,2116,2116,2118,2118,0,0,0,0,0,0,0,0,0,0,0,0,0,0,0,0,0,0,0,0,
0,0,0,0,0,0,0,0,0,0,0,2114,2115,2115,2115,2115,2115,2116,2116,2118,2118,0,0,0,0,0,0,0,0,0,0,0,0,0,0,0,0,0,0,0,
0,0,0,0,0,0,0,0,0,0,0,0,2114,2114,2115,2115,2115,2115,2116,2116,2116,2119,2119,0,0,0,0,0,0,0,0,0,0,0,0,0,0,0,0,0,
0,0,0,0,0,0,0,0,0,0,0,0,0,0,2114,2114,2114,2114,2115,2115,2116,2116,2117,2150,2151,2151,0,0,0,0,0,0,0,0,0,0,0,0,0,0,
0,0,0,1030,0,1030,1030,0,1030,0,0,0,0,0,0,0,0,0,2114,2114,2115,2116,2117,2117,2117,2151,2151,2151,0,0,0,0,0,0,0,0,0,0,0,0,
0,0,0,1062,1030,1031,1031,1030,1062,1030,0,0,0,0,0,0,0,0,0,2114,2114,2115,2116,2116,2117,2117,2150,2150,0,2151,2151,0,0,0,0,0,0,0,0,0,
0,0,0,0,1062,1062,1062,1031,1030,1062,1030,0,0,0,0,0,0,0,0,0,2114,2115,2115,2116,2116,2117,2117,2150,0,2150,2150,2151,0,0,0,0,0,0,0,0,
0,0,0,0,0,0,0,1062,1031,1030,1031,0,0,0,0,0,0,0,0,0,0,2114,2115,2115,2116,2117,2117,2117,0,2117,2150,2150,2151,0,0,0,0,0,0,0,
0,0,0,0,0,0,0,0,1062,1062,1062,0,0,0,0,0,0,0,0,0,0,0,2114,2114,2114,2116,2116,2117,0,2117,2117,2150,2150,2151,0,0,0,0,0,0,
0,0,0,0,0,0,0,0,0,0,0,0,0,0,0,0,0,0,0,0,0,0,0,0,0,0,0,0,0,0,0,0,0,0,0,0,0,0,0,0,
0,0,0,0,0,0,0,0,0,0,0,0,0,0,0,0,0,0,0,0,0,0,0,0,2114,2114,2115,2115,2116,2116,2117,2117,2117,2150,2151,0,0,0,0,0,
0,0,1481,1450,1450,1450,1450,0,1450,1450,1450,1450,1482,0,0,0,0,0,0,0,0,0,0,0,0,2114,2114,2115,2116,2116,2116,2117,2117,2150,2151,0,0,0,0,0,
0,0,1481,0,0,0,0,0,0,0,0,0,1482,0,0,0,0,0,0,0,0,0,0,0,0,0,2114,2115,2115,2116,2116,2148,2117,2117,2151,2151,0,0,0,0,
0,0,1481,0,0,0,0,0,0,0,0,0,1482,0,0,0,0,0,0,0,0,0,0,0,0,0,0,2114,2115,2115,2116,2116,2117,2150,2150,2151,0,0,0,0,
0,0,0,0,0,0,0,0,0,0,0,0,0,0,0,0,0,0,0,0,0,0,0,0,0,0,0,2114,2114,2115,2116,2116,2117,2150,2150,2151,0,0,0,0,
0,0,1481,0,0,0,0,0,0,0,0,0,1482,0,0,0,0,0,0,0,0,0,0,0,0,0,0,2114,2115,2115,2116,2117,2117,2117,2151,0,0,0,0,0,
0,0,1481,0,0,0,0,0,0,0,0,0,1482,0,0,0,0,0,0,0,0,0,0,0,0,0,2114,2114,2115,2116,2116,2117,2117,2150,2151,0,0,0,0,0,
0,0,1481,1450,1450,1450,1450,0,1450,1450,1450,1450,1514,0,0,0,0,0,0,0,0,0,0,0,0,0,2114,2115,2115,2116,2117,2117,2117,2151,0,0,0,0,0,0,
0,0,0,0,0,0,0,0,1505,1506,1505,1506,0,0,0,0,0,0,0,0,0,0,0,0,0,2114,2114,2115,2116,2116,2117,2150,2150,2151,0,0,0,0,0,0,
0,0,0,0,0,0,0,0,1537,1507,1508,1538,1505,1506,0,0,0,0,0,0,0,0,0,0,0,2114,2115,2115,2116,2116,2117,2150,2151,0,0,0,0,0,0,0,
0,0,1505,1506,0,0,0,0,0,1537,1538,0,1537,1538,0,0,0,0,0,0,0,0,0,0,2114,2114,2115,2116,2116,2117,2150,2151,0,0,0,0,0,0,0,0,
0,0,1537,1538,0,1505,1506,0,0,0,1505,1506,1505,1506,0,0,0,0,0,0,0,0,0,0,2114,2115,2115,2116,2117,2117,2150,2151,0,0,0,0,0,0,0,0,
0,0,0,1505,1506,1537,1538,0,0,1505,1475,1538,1537,1538,0,0,0,0,0,0,0,0,0,2114,2115,2115,2116,2116,2117,2150,2151,0,0,0,0,0,0,0,0,0,
0,1505,1506,1537,1538,0,0,1505,1506,1537,1538,1505,1506,1505,1506,0,0,0,0,0,0,0,2114,2114,2115,2116,2116,2117,2150,2150,0,0,0,0,0,0,0,0,0,0,
0,1537,1538,0,1505,1506,1505,1475,1476,1506,1505,1475,1476,1475,1476,1506,0,0,0,0,0,2114,2114,2115,2115,2116,2117,2117,2150,0,0,0,0,0,0,0,0,0,0,0,
0,0,0,0,1537,1538,1537,1507,1508,1538,1537,1507,1508,1507,1508,1538,0,0,0,0,0,2114,2115,2115,2116,2116,2117,2150,2151,0,0,0,0,0,0,0,0,0,0,0
0,0,0,0,0,0,0,0,0,0,0,0,0,0,0,0,0,0,0,0,0,0,0,0,0,0,0,0,1961,0,0,0,0,0,0,0,0,0,0,0,
0,0,0,0,0,0,0,0,0,0,0,0,0,0,0,0,0,0,0,0,0,0,0,0,0,0,0,0,1961,0,0,0,0,0,0,0,0,0,0,0,
0,0,0,0,0,0,0,0,0,0,0,0,0,0,0,0,0,0,0,0,0,0,0,0,0,0,0,0,1961,0,0,0,0,0,0,0,0,0,0,0,
0,0,0,0,0,0,0,0,0,0,0,0,0,1190,0,0,0,1027,0,0,0,0,0,1028,0,0,0,0,1961,0,0,0,0,0,0,0,0,0,0,0,
0,0,0,0,0,0,0,0,1026,0,1027,0,0,0,0,0,0,0,0,0,0,0,0,0,0,0,0,0,1961,0,0,0,0,0,0,0,0,0,0,0,
0,0,0,0,0,0,0,0,1026,1026,0,0,0,0,0,0,1190,0,0,1192,0,0,0,0,0,0,1028,0,1961,0,0,0,0,0,0,0,0,0,0,0,
0,0,0,0,0,0,0,0,0,0,1026,1026,0,0,0,0,0,0,0,0,0,0,0,0,0,0,0,0,1961,0,0,0,0,0,0,0,0,0,0,0,
0,0,0,0,0,0,0,0,0,0,0,0,0,0,0,0,0,0,0,0,0,0,1192,0,0,0,0,0,1961,0,0,0,0,0,0,0,0,0,0,0,
0,0,0,0,1058,0,0,0,0,0,0,0,0,0,0,0,0,1027,0,0,1190,0,0,0,0,0,1192,0,1961,0,1027,0,0,0,0,0,0,0,0,0,
0,0,0,0,0,0,0,0,0,0,1026,0,0,0,0,0,1026,0,0,0,0,0,0,0,0,0,0,0,1961,0,0,0,0,1028,0,0,0,0,0,0,
0,1058,0,0,0,0,0,0,0,0,0,0,1028,0,0,0,0,0,0,0,0,0,0,0,0,0,1190,0,1961,0,0,0,0,0,0,0,0,0,0,0,
0,0,0,0,0,1058,0,0,0,0,0,0,0,1058,0,0,0,0,0,1026,0,0,0,0,0,0,0,0,1961,0,1192,0,0,0,0,0,0,0,0,0,
0,0,0,0,0,0,0,0,0,0,0,0,0,1028,0,0,0,0,0,0,0,0,0,0,0,0,0,0,1961,0,0,0,0,0,0,0,0,0,0,0,
0,1930,1931,1931,1931,1931,1931,1931,1931,1931,1931,1931,1931,1931,1931,1931,1931,1931,1931,1931,1931,1931,1931,1931,1931,1931,1931,1931,1998,1931,1931,1931,1931,1931,1931,1931,1931,1964,0,0,
0,993,0,0,0,0,0,0,0,0,0,0,0,0,0,0,0,0,1026,1026,0,0,0,0,0,0,0,1191,0,1191,0,0,0,0,0,1027,0,1961,0,0,
0,0,0,0,0,0,0,0,0,0,0,0,0,0,0,0,0,0,0,0,0,0,0,0,0,0,0,0,0,1191,0,0,0,0,1192,0,0,1961,0,0,
0,0,0,1703,1703,1703,1703,0,1703,1703,1703,1703,0,0,0,0,0,0,0,0,0,0,0,0,1027,0,0,0,0,0,0,0,1191,0,0,0,0,1961,0,0,
0,0,0,1703,1703,1703,1703,0,1703,1703,1703,1703,0,0,0,0,0,0,0,0,0,0,1026,0,0,0,0,0,0,0,0,0,0,0,0,0,0,1961,0,0,
0,0,0,0,0,0,0,0,0,0,0,0,0,0,0,0,0,0,0,0,0,0,0,0,0,0,0,0,0,1190,0,0,1191,0,1192,0,0,1961,0,0,
0,0,0,1672,1672,1672,1672,0,1672,1672,1672,1672,0,0,0,0,0,0,0,0,0,0,0,0,1026,0,0,0,0,0,1190,0,0,1191,0,0,0,1961,0,0,
0,0,0,1672,1672,1672,1672,0,1672,1672,1672,1672,0,0,0,0,0,0,0,0,0,0,0,0,0,0,0,0,0,0,0,0,0,0,0,0,0,1961,0,0,
0,0,0,0,0,0,0,0,0,0,0,0,0,0,0,0,0,0,0,0,0,0,0,0,0,1027,0,0,0,0,1190,0,0,0,0,0,0,1961,0,0,
0,0,0,0,0,0,0,0,0,0,0,0,0,0,0,0,0,0,0,0,0,0,0,1026,0,0,0,0,0,0,0,0,0,0,0,0,0,1997,1931,1931,
0,0,0,0,0,0,0,0,0,0,0,0,0,0,0,0,0,0,0,0,0,0,0,0,0,0,0,0,1191,0,0,0,1192,0,0,1028,0,1961,0,0,
0,1285,0,0,0,0,0,0,0,0,0,0,0,0,0,0,0,0,1026,0,0,0,0,0,0,0,0,0,1190,0,0,0,0,0,0,0,0,1961,0,0,
0,1317,0,0,0,0,0,0,1285,0,0,0,0,0,0,0,1285,0,0,0,0,0,0,0,0,0,0,0,0,0,0,0,0,0,0,0,0,1961,0,0,
0,0,0,0,0,0,0,0,1317,0,0,0,0,0,0,0,1317,0,0,0,0,0,0,0,0,0,1190,0,0,0,0,0,0,0,0,0,0,1961,0,0,
0,0,0,0,0,0,0,0,0,0,0,0,0,0,0,0,0,0,0,0,0,0,0,0,0,0,0,0,0,0,0,0,0,0,0,1028,0,1961,0,0,
0,0,0,1285,0,0,0,0,0,0,0,0,0,0,0,0,0,0,0,1026,1026,0,0,0,0,1190,0,0,0,0,0,0,0,0,0,0,0,1961,0,0,
0,0,0,1317,0,0,0,0,0,0,0,0,0,0,0,0,0,0,0,0,0,0,0,0,0,0,0,0,0,0,0,0,0,1028,0,0,0,1961,0,0