40
30
20
500
577,577,577,577,577,577,577,577,1961,577,577,577,577,577,577,577,577,577,577,577,577,577,577,577,577,577,577,577,577,577,577,577,577,577,577,577,577,577,577,577,
577,577,577,577,577,577,577,577,1961,577,577,577,577,577,577,577,577,577,577,577,577,577,577,577,577,577,577,577,577,577,577,577,577,577,577,577,577,577,577,577,
577,577,577,577,577,577,577,577,1961,577,577,577,577,577,577,577,577,577,577,577,577,577,577,577,577,577,577,577,577,577,577,577,577,577,577,577,577,577,577,577,
577,577,577,577,577,577,577,577,1961,577,577,577,577,577,577,577,577,577,577,577,577,577,577,577,577,577,577,577,577,577,577,577,577,577,577,577,577,577,577,577,
577,577,577,577,577,577,577,577,1962,577,577,577,577,577,577,577,577,577,577,577,577,577,577,577,577,577,577,577,577,577,577,577,577,577,577,577,577,577,577,577,
577,577,577,577,577,577,577,577,1962,577,577,577,577,577,577,577,577,577,577,577,577,577,577,577,577,577,577,577,577,577,577,577,577,577,577,577,577,577,577,577,
577,577,577,577,577,577,577,577,1962,577,577,577,577,577,577,577,577,577,577,577,577,577,577,577,577,577,577,577,577,577,577,577,577,577,577,577,577,577,577,577,
577,577,577,577,577,577,577,577,1962,577,577,577,577,577,577,577,577,577,577,577,577,577,577,577,577,577,577,577,577,577,577,577,577,577,577,577,577,577,577,577,
577,577,577,577,577,577,577,577,1961,577,577,577,577,577,577,577,577,577,577,577,577,577,577,577,577,577,577,577,577,577,577,577,577,577,577,577,577,577,577,577,
577,577,577,577,577,577,577,577,1961,577,577,577,577,577,577,577,577,577,577,577,577,577,577,577,577,577,577,577,577,577,577,577,577,577,577,577,577,577,577,577,
577,577,577,577,577,577,577,577,1961,577,577,577,577,577,577,577,577,577,577,577,577,577,577,577,577,577,577,577,577,577,577,577,577,577,577,577,577,577,577,577,
577,577,577,577,577,577,577,577,1967,1931,1931,1931,1931,1931,1931,1931,1931,1931,1931,1931,1931,1931,1931,1931,1931,1931,1931,1931,1931,1931,1931,1931,1931,1931,1931,1931,1931,1931,1931,1931,
577,577,577,577,577,577,577,577,1961,577,577,577,577,577,577,577,577,577,577,577,577,577,577,577,577,577,577,577,577,577,577,577,577,577,577,577,577,577,577,577,
577,577,577,577,577,577,577,577,1961,577,577,577,577,577,577,577,577,577,577,577,577,577,577,577,577,577,577,577,577,577,577,577,577,577,577,577,577,577,577,577,
577,577,577,577,577,577,577,577,1961,577,577,577,577,577,577,577,577,577,577,577,577,577,577,577,577,577,577,577,577,577,577,577,577,577,577,577,577,577,577,577,
577,577,577,577,577,577,577,577,1961,577,577,577,577,577,577,577,577,577,577,577,577,577,577,577,577,577,577,577,577,577,577,577,577,577,577,577,577,577,577,577,
577,577,577,577,577,577,577,577,1961,577,577,577,577,577,577,577,577,577,577,577,577,577,577,577,577,577,577,577,577,577,577,577,577,577,577,577,577,577,451,451,
577,577,577,577,577,577,577,577,1961,577,577,577,577,577,577,577,577,577,577,577,577,577,577,577,577,577,577,577,577,577,577,577,577,577,577,577,451,451,451,207,
577,577,577,577,577,577,577,577,1961,577,577,577,577,577,577,577,577,577,577,577,577,577,577,577,577,577,577,577,577,577,577,577,577,577,577,451,451,207,207,207,
577,577,577,577,577,577,577,577,1961,577,577,577,577,577,577,577,577,577,577,577,577,577,577,577,577,577,577,577,577,577,577,577,577,577,451,451,207,207,207,207,
577,577,577,577,577,577,577,577,1961,577,577,577,577,577,577,577,577,577,577,577,577,577,577,577,577,577,577,577,577,577,577,577,577,451,451,207,207,207,207,207,
577,577,577,577,577,577,577,577,1961,577,577,577,577,577,577,577,577,577,577,577,577,577,577,577,577,577,577,577,577,577,577,577,451,451,207,207,207,207,207,207,
577,577,577,577,577,577,577,577,1961,577,577,577,577,577,577,577,577,577,577,577,577,577,577,577,577,577,577,577,577,577,577,451,451,207,207,207,207,207,207,207,
577,577,577,577,577,577,577,577,1961,577,577,577,577,577,577,577,577,577,577,577,577,577,577,577,577,577,577,577,577,577,451,451,207,207,207,207,207,207,207,207,
577,577,577,577,577,577,577,577,1961,577,577,577,577,577,577,577,577,577,577,577,577,577,577,577,577,577,577,577,577,451,451,207,207,207,207,207,207,207,207,207,
577,577,577,577,577,577,577,577,1961,577,577,577,577,577,577,577,577,577,577,577,577,577,577,577,577,577,577,577,451,451,207,207,207,207,207,207,207,207,207,207,
577,577,577,577,577,577,577,577,1961,577,577,577,577,577,577,577,577,577,577,577,577,577,577,577,577,577,577,451,451,207,207,207,207,207,207,207,207,207,207,207,
577,577,577,577,577,577,577,577,1961,577,577,577,577,577,577,577,577,577,577,577,577,577,577,577,577,577,451,451,207,207,207,207,207,207,207,207,207,207,207,207,
577,577,577,577,577,577,577,577,1961,577,577,577,577,577,577,577,577,577,577,577,577,577,577,577,577,451,451,207,207,207,207,207,207,207,207,207,207,207,207,207,
577,577,577,577,577,577,577,577,1961,577,577,577,577,577,577,577,577,577,577,577,577,577,577,577,577,451,207,207,207,207,207,207,207,207,207,207,207,207,207,207
0,0,0,0,0,0,0,0,0,0,0,0,0,0,0,0,0,0,0,0,0,0,0,0,0,0,0,0,0,0,0,0,0,0,0,0,0,0,0,0,
0,0,0,0,0,0,0,0,0,0,0,0,0,0,0,0,0,0,0,0,0,0,1639,1639,0,0,0,0,1125,0,0,0,0,0,0,0,0,0,0,0,
0,0,0,0,0,0,0,0,0,0,0,0,0,0,1639,0,0,0,0,0,0,0,0,0,0,0,0,0,1157,0,0,0,0,0,0,0,0,0,0,0,
0,0,0,0,0,0,0,0,0,0,0,0,0,0,1639,0,0,0,0,0,0,0,0,0,1889,0,0,0,0,0,1639,0,0,0,0,0,0,0,0,0,
0,0,0,0,0,0,0,0,0,0,0,0,0,0,0,0,0,0,0,0,0,0,0,0,1921,0,0,0,0,0,0,0,0,0,0,0,0,0,0,0,
0,0,0,0,0,0,0,0,0,0,0,0,0,0,0,0,0,0,0,0,0,0,0,0,0,0,0,0,0,0,1639,0,0,0,0,0,0,0,0,0,
0,0,0,0,1889,0,0,0,0,0,0,0,0,0,1889,0,0,0,0,0,0,0,0,0,0,0,0,0,0,0,1889,0,0,0,0,0,0,0,1639,0,
0,0,0,0,1921,0,1125,0,0,0,0,0,0,0,1921,0,0,0,0,0,0,0,0,0,0,0,0,0,0,0,1921,0,0,0,0,0,0,0,0,0,
0,0,0,0,0,0,1157,0,0,0,0,0,0,0,0,0,0,0,0,0,0,0,0,0,0,0,0,0,0,0,0,0,0,0,0,0,0,1639,0,0,
0,0,0,0,0,0,0,1633,0,0,0,0,0,0,0,0,0,0,0,0,0,0,0,0,0,0,0,0,0,0,0,0,0,0,0,0,0,1639,0,0,
0,0,0,0,0,0,0,1665,0,0,0,0,0,0,0,0,0,0,0,0,0,0,0,0,0,0,0,0,0,0,0,0,0,0,0,0,0,0,0,0,
0,0,0,0,0,1639,0,1697,0,0,0,0,0,0,0,0,0,1441,1442,0,0,0,0,0,0,0,0,0,0,0,0,0,0,0,0,0,0,0,0,0,
0,0,0,0,0,0,1639,0,0,0,0,1857,0,0,0,0,0,1473,1474,0,0,0,0,0,0,0,1889,0,0,0,0,0,0,0,0,0,0,0,1889,0,
0,0,0,0,0,0,0,0,0,0,0,0,0,0,0,0,0,0,0,0,0,0,0,1889,0,0,1921,0,0,0,0,0,0,0,0,1639,0,0,1921,0,
0,0,0,0,1889,0,0,0,0,0,0,0,0,0,0,1857,0,0,0,0,0,0,0,1921,0,0,0,0,0,0,0,0,0,0,0,1639,0,0,0,0,
0,0,0,0,1921,0,0,0,0,0,0,0,0,0,0,0,0,0,0,0,0,0,0,0,0,0,0,0,0,0,0,0,0,0,0,0,0,0,0,0,
0,0,0,0,0,0,1639,0,0,0,0,0,0,0,0,1889,0,0,0,0,0,0,0,0,0,0,0,0,0,0,0,0,0,1889,0,0,0,0,0,0,
0,0,0,0,0,0,0,0,0,0,1639,0,0,0,0,1921,0,0,0,0,0,0,0,1857,0,0,0,0,0,0,0,1857,0,1921,0,0,0,0,0,1739,
0,0,0,0,0,0,0,0,0,0,0,1125,0,0,0,0,0,0,0,1857,0,0,0,0,0,0,0,0,0,0,0,0,0,0,0,0,0,1739,0,1771,
0,0,0,0,0,0,0,0,0,0,0,1157,0,0,0,0,0,0,0,0,0,0,0,0,0,0,0,0,0,0,0,0,0,0,0,0,0,1771,0,0,
0,0,0,0,0,0,1287,0,0,0,0,0,0,0,0,0,0,0,1639,1639,0,0,0,0,0,0,0,0,0,0,0,0,0,0,1739,0,0,0,0,0,
0,0,0,0,0,0,1319,0,0,0,0,0,0,0,0,0,0,1639,1639,0,0,0,0,0,0,0,0,1857,1857,0,0,0,0,0,1771,0,0,0,0,0,
0,0,0,0,0,0,0,0,0,0,0,0,0,0,1639,0,1639,1639,1639,0,0,0,0,0,0,0,1154,0,0,0,0,0,0,0,0,0,0,0,0,0,
0,0,0,0,0,0,0,0,0,0,0,0,0,0,0,1639,1639,0,0,0,0,0,0,0,0,0,0,0,0,0,0,0,1739,0,0,0,0,0,1439,0,
0,0,0,0,0,0,0,0,0,0,0,0,0,0,0,1639,1639,0,0,0,0,0,0,0,0,0,0,0,0,0,0,0,1771,0,0,0,0,0,1471,0,
0,1857,0,0,0,0,0,0,0,0,0,0,0,0,0,0,0,0,0,0,0,0,0,0,0,0,0,0,0,0,1739,0,0,0,0,0,0,1803,0,0,
0,0,0,0,0,0,0,0,0,0,0,0,0,0,0,0,0,0,0,0,0,0,0,0,0,0,0,0,0,0,1771,0,0,0,0,0,0,0,0,0,
0,0,0,0,1857,1857,0,0,0,0,0,0,0,0,0,0,0,0,0,0,0,0,0,0,0,0,0,0,0,0,0,0,0,0,0,0,0,0,0,0,
0,0,0,0,0,0,0,0,0,0,0,1154,0,0,0,0,0,0,0,0,0,0,0,0,0,0,0,1739,0,0,0,0,0,0,1803,0,0,0,0,0,
0,0,0,0,0,0,0,0,0,0,0,0,0,0,0,0,0,0,0,0,0,0,0,0,0,0,0,1771,0,0,0,0,0,0,0,0,0,0,0,0
0,0,0,0,0,0,0,0,0,0,0,0,1734,1734,1734,1734,1734,0,0,0,0,0,0,0,0,0,0,0,0,0,0,0,0,0,0,0,0,1734,0,0,
0,0,0,1825,0,0,0,0,0,0,0,0,0,1734,1734,1734,1734,1734,0,0,0,0,0,0,0,0,0,0,0,0,0,0,0,0,1285,0,1734,1734,0,0,
0,0,0,0,0,0,0,0,0,0,0,0,0,0,0,1734,1734,1734,0,0,0,0,0,0,0,0,1825,0,0,0,0,0,1825,0,1317,0,1734,0,0,0,
0,0,0,0,0,1825,0,0,0,0,0,0,0,0,0,0,1734,1734,1734,0,1826,0,0,0,0,0,0,0,0,0,0,0,0,0,0,1734,1734,1826,0,0,
0,0,1285,0,0,0,0,0,0,0,0,0,0,0,0,0,0,1734,1734,0,0,0,0,0,0,0,0,1734,0,0,0,0,0,0,0,1734,0,0,0,0,
0,0,1317,0,0,0,0,0,0,0,0,1826,0,1825,0,0,0,0,1734,1734,0,0,0,1825,0,0,1734,0,0,0,0,0,1826,0,1734,1734,0,0,0,0,
0,0,0,0,0,0,0,0,0,0,0,0,0,0,0,0,0,0,0,1734,1734,0,0,0,0,1734,0,0,1285,0,0,0,0,0,1734,1734,0,0,0,0,
0,0,0,0,0,0,0,0,0,0,0,0,0,0,0,0,0,0,0,0,1734,1734,1734,0,1734,1734,0,0,1317,0,0,0,0,1734,1734,0,1825,0,0,0,
0,0,1826,0,0,0,0,0,0,0,0,0,1285,0,0,0,0,0,0,0,1734,0,1734,1734,1734,0,0,0,0,0,0,0,0,1734,0,0,0,0,0,0,
0,0,0,0,0,0,0,0,0,0,0,0,1317,0,0,0,0,0,0,0,1734,0,0,0,1734,1734,1734,1734,0,0,0,1734,1734,1734,0,0,0,0,0,0,
0,0,0,0,0,0,0,0,0,0,0,0,0,0,0,0,0,0,0,0,0,0,0,0,0,0,0,1734,1734,1734,0,1734,0,0,0,0,0,0,0,0,
0,0,0,0,0,0,0,0,0,0,0,0,0,0,0,0,0,0,0,0,0,0,0,0,0,0,0,0,0,0,0,0,0,0,0,0,0,0,0,0,
0,0,0,0,0,0,0,0,0,0,0,0,0,0,0,0,0,0,0,0,0,0,0,0,0,0,0,0,0,1734,1734,1734,0,0,0,0,0,0,0,0,
0,0,0,0,0,0,0,0,0,0,0,0,0,0,0,0,0,0,0,0,0,0,0,0,0,0,0,0,0,1734,1734,0,0,0,0,0,0,0,0,0,
0,0,0,0,0,0,0,0,0,0,0,0,0,0,0,0,0,0,0,0,0,0,0,0,0,0,0,0,1734,1734,1734,0,0,1285,0,0,0,0,0,0,
0,0,1826,0,0,0,0,0,0,0,0,0,0,0,0,0,0,0,0,1734,1734,0,0,0,0,0,1825,1734,1734,1734,0,0,0,1317,0,0,0,0,0,0,
0,0,0,0,0,0,0,0,0,0,0,0,0,0,0,0,0,0,1734,1734,0,0,0,0,0,0,1734,1734,1734,0,0,0,0,0,0,0,0,0,0,0,
0,0,0,0,0,0,0,0,0,0,0,0,0,0,1285,0,0,0,0,0,0,0,0,0,0,1734,1734,1734,0,0,0,0,0,0,0,0,0,0,0,0,
0,0,0,0,0,0,0,0,0,0,0,0,0,0,1317,0,0,0,0,0,0,0,0,0,0,1734,1734,0,1825,0,1285,0,0,0,0,0,0,0,0,0,
0,0,0,1826,1826,0,0,0,0,0,0,0,0,0,0,0,0,0,0,1826,0,0,0,0,1734,1734,0,0,0,0,1317,0,0,0,0,0,0,0,0,0,
0,0,0,0,0,0,0,0,0,0,0,0,0,0,0,0,0,0,0,0,0,0,0,1734,1734,1734,0,0,0,1826,0,0,0,0,0,0,0,0,0,0,
0,0,0,0,0,0,0,0,0,0,0,0,1734,0,0,0,0,0,0,0,0,0,1734,1734,0,0,0,0,0,0,0,0,0,0,0,0,0,0,0,0,
0,0,1826,0,0,0,0,0,0,0,0,1734,1734,0,0,0,0,0,0,0,0,1734,1734,1734,0,0,0,0,0,0,0,0,0,0,0,0,0,0,0,0,
0,0,0,0,0,1826,0,0,0,0,0,1734,0,0,0,0,0,0,0,0,1734,1734,1734,1734,0,0,0,0,0,0,0,0,0,0,0,0,0,0,0,0,
0,0,0,0,0,0,0,0,0,0,1734,0,0,0,0,0,0,0,0,1734,1734,1734,1734,1734,1825,0,0,0,0,0,0,0,0,0,0,0,0,0,0,0,
0,0,0,0,0,0,0,0,0,1734,1734,0,0,0,1826,0,0,0,0,1734,1734,1734,0,0,0,1286,0,0,0,0,0,0,0,0,0,0,0,0,0,0,
0,0,0,1826,0,0,0,0,0,1734,0,0,0,0,0,0,0,1734,1734,1734,1734,1734,1734,0,0,1318,0,0,0,0,0,0,0,0,0,0,0,0,0,0,
0,0,1286,0,0,0,0,0,0,0,0,0,0,0,0,0,1734,1734,1734,1734,1734,1734,1734,0,0,0,0,0,0,0,0,0,0,0,0,0,0,0,0,0,
0,0,1318,0,0,0,0,0,0,0,0,0,0,0,0,1734,1734,1734,1734,0,0,0,0,0,0,0,0,0,0,0,0,0,0,0,0,0,0,0,0,0,
0,0,0,0,0,0,0,0,0,0,0,0,0,0,1734,1734,1734,1734,1734,0,0,0,0,0,0,0,0,0,0,0,0,0,0,0,0,0,0,0,0,0
