40
30
20
500
577,577,577,577,577,577,73,73,73,73,73,73,73,73,73,73,73,73,73,73,73,73,73,73,73,73,73,73,73,73,73,73,73,73,73,73,73,73,73,73,
577,577,577,577,577,577,577,577,577,577,577,577,577,577,577,73,73,73,577,577,577,73,73,73,73,73,73,73,73,73,73,73,73,73,73,577,577,577,577,577,
577,577,577,577,577,577,577,577,577,577,577,577,577,577,577,577,577,577,577,577,577,577,577,577,577,577,577,577,577,577,577,577,577,577,577,577,577,577,577,577,
577,577,577,577,577,577,0,577,577,577,577,577,577,0,0,0,0,0,577,577,577,577,577,577,577,577,577,577,577,577,577,577,577,577,577,0,0,0,0,0,
577,577,577,577,577,577,577,577,577,0,577,577,0,0,0,0,0,0,0,0,0,0,0,0,0,0,0,0,0,0,0,0,0,0,0,0,0,0,0,0,
577,577,577,577,577,577,577,577,577,577,577,0,0,0,0,0,0,0,0,0,0,0,0,577,577,577,577,577,577,577,577,577,577,577,577,577,0,0,0,577,
577,577,577,577,577,577,577,577,577,577,577,577,577,577,0,0,0,0,0,0,0,0,577,577,577,577,577,577,577,73,73,73,73,73,73,577,577,577,577,577,
577,577,577,577,577,577,577,577,577,577,577,577,577,577,577,0,0,0,0,0,577,577,577,577,73,73,73,73,73,73,73,73,73,73,73,73,73,73,73,73,
577,577,577,577,73,73,73,73,73,577,577,577,577,577,577,577,0,0,0,0,577,577,577,73,73,73,73,73,73,73,73,73,73,73,73,73,73,73,73,73,
73,73,73,73,73,73,73,73,73,73,73,73,577,577,577,577,577,0,0,0,0,577,577,73,73,73,73,73,73,73,73,73,73,73,73,73,73,73,73,73,
73,73,73,73,73,73,73,73,73,73,73,73,73,73,577,577,577,0,0,0,0,577,577,73,73,73,73,73,73,73,73,73,73,73,73,73,73,73,73,73,
73,73,73,73,73,73,73,73,73,73,73,73,73,73,73,577,577,0,0,0,0,577,73,73,73,73,73,73,73,73,73,73,73,73,73,73,73,73,73,73,
73,73,73,73,73,73,73,73,73,73,73,73,73,73,73,577,577,577,0,0,0,577,73,73,73,73,73,73,73,73,73,73,73,73,73,73,73,73,73,73,
73,73,73,73,73,73,73,73,73,73,73,73,73,73,73,577,577,577,0,0,0,577,73,73,73,73,73,73,73,73,73,73,73,73,73,73,73,73,73,73,
73,73,73,73,73,73,73,73,73,73,73,73,73,73,73,73,577,577,0,0,0,577,73,73,73,73,73,73,73,73,73,73,73,73,73,73,73,73,73,73,
73,73,73,73,73,73,73,73,73,73,73,73,73,73,73,73,577,577,577,0,577,73,73,73,73,73,73,73,73,73,73,73,73,73,73,73,73,73,73,73,
73,73,73,73,73,73,73,73,73,73,73,73,73,73,73,73,73,577,577,0,577,73,73,73,73,73,73,73,73,73,73,73,73,73,73,73,73,73,73,73,
73,73,73,73,73,73,73,73,73,73,73,73,73,73,73,73,73,577,577,577,577,73,73,73,73,73,73,73,73,73,73,73,73,73,73,73,73,73,73,73,
73,73,73,73,73,73,73,73,73,73,73,73,73,73,73,73,73,73,73,577,577,73,73,73,73,73,73,73,73,73,73,73,73,73,73,73,73,73,73,73,
73,73,73,73,73,73,73,73,73,73,73,73,73,73,73,73,73,73,73,73,73,73,73,73,73,73,73,73,73,73,73,73,73,73,73,73,73,73,73,73,
73,73,73,73,73,73,73,73,73,73,73,73,73,73,73,73,73,73,73,73,73,73,73,73,73,73,73,73,73,73,73,73,73,73,73,73,73,73,73,73,
1931,1931,1931,1931,1931,1931,1931,1931,1931,1931,1931,1931,1931,1931,1931,1931,1931,1931,1931,1931,1931,1931,1931,1931,1931,1931,1931,1931,1931,1931,1931,1931,1931,1931,1931,1931,1931,1931,1931,1931,
73,73,73,73,73,73,73,73,73,73,73,73,73,73,73,73,73,73,73,73,73,73,73,73,73,73,73,73,73,73,73,73,73,73,73,73,73,73,73,73,
73,73,73,73,73,73,73,73,73,73,73,73,73,73,73,73,73,73,73,73,73,73,73,73,73,73,73,73,73,73,73,73,73,73,73,73,73,73,73,73,
73,73,73,73,73,73,73,73,73,73,73,73,73,73,73,73,73,73,73,73,73,73,73,73,73,73,73,73,73,73,73,73,73,73,73,73,73,73,73,73,
73,73,73,73,73,73,73,73,73,73,73,73,73,73,73,73,73,73,73,73,73,73,73,73,73,73,73,73,73,73,73,73,73,73,73,73,73,73,73,73,
73,73,73,73,73,73,73,73,73,73,73,73,73,73,73,73,73,73,73,73,73,73,73,73,73,73,73,73,73,73,73,73,73,73,73,73,73,73,73,73,
73,73,73,73,73,73,73,73,73,73,73,73,73,73,73,73,73,73,73,73,73,73,73,73,73,73,73,73,73,73,73,73,73,73,73,73,73,73,73,73,
73,73,73,73,73,73,73,73,73,73,73,73,73,73,73,73,73,73,73,73,73,73,73,73,73,73,73,73,73,73,73,73,73,73,73,73,73,73,73,73,
73,73,73,73,73,73,73,73,73,73,73,73,73,73,73,73,73,73,73,73,73,73,73,73,73,73,73,73,73,73,73,73,73,73,73,73,73,73,73,73
0,0,0,0,0,0,0,0,0,0,0,0,0,0,0,0,0,0,0,0,0,0,0,0,0,0,0,0,0,0,0,0,0,0,0,0,0,0,0,0,
0,0,0,0,0,0,0,0,0,0,0,0,0,0,0,0,0,0,0,0,0,0,0,0,0,0,0,0,0,0,0,0,0,0,0,0,0,0,0,0,
0,0,0,0,0,0,0,0,0,0,0,0,0,0,0,0,0,0,0,0,0,0,0,0,0,0,0,0,0,0,0,0,0,0,0,0,0,0,0,0,
0,0,0,0,0,0,2086,0,0,0,0,0,0,2051,2051,2051,2051,2051,0,0,0,0,0,0,0,0,0,0,0,0,0,0,0,0,0,2051,2051,2051,2051,2051,
0,0,0,0,0,0,0,0,0,2086,0,0,2115,2051,2083,2083,2084,2085,2054,2051,2051,2051,2051,2051,2051,2051,2051,2051,2051,2051,2051,2051,2051,2051,2051,2051,2051,2051,2051,2051,
0,0,0,0,0,0,0,0,0,0,0,2114,2210,2179,2179,2179,2148,2149,2180,2180,2180,2180,2180,0,0,0,0,0,0,0,0,0,0,0,0,0,2051,2051,2051,0,
0,0,0,0,0,0,0,0,0,0,0,0,0,0,2210,2179,2179,2148,2116,2180,2180,2180,0,0,0,0,0,0,0,0,0,0,0,0,0,0,0,0,0,0,
0,0,0,0,0,0,0,0,0,0,0,0,0,0,0,2210,2179,2179,2148,2180,0,0,0,0,0,0,0,0,0,0,0,0,0,0,0,0,0,0,0,0,
0,1449,1449,1449,1449,1449,0,1449,1449,1449,1449,1449,0,0,0,0,2210,2179,2148,2180,0,0,0,1449,1449,1449,1449,1449,0,1449,1449,1449,1449,1449,0,0,0,0,0,0,
0,1449,0,0,0,0,0,0,0,0,0,1449,0,0,0,0,0,2179,2179,2148,2180,0,0,1449,0,0,0,0,0,0,0,0,0,1449,0,0,0,0,0,0,
0,1449,0,0,0,0,0,0,0,0,0,1449,0,0,0,0,0,2212,2179,2149,2151,0,0,1449,0,0,0,0,0,0,0,0,0,1449,0,0,0,0,0,0,
0,1449,0,0,0,0,1634,0,0,0,0,1449,0,0,0,0,0,2212,2179,2179,2151,0,0,1449,0,0,0,0,1634,0,0,0,0,1449,0,0,0,0,0,0,
0,0,0,0,0,0,1666,0,0,0,0,0,0,0,0,0,0,0,2212,2179,2151,0,0,0,0,0,0,0,1666,0,0,0,0,0,0,0,0,0,0,0,
0,1449,0,0,0,0,0,0,0,0,0,1449,0,0,0,0,0,0,2212,2151,2151,0,0,1449,0,0,0,0,0,0,0,0,0,1449,0,0,0,0,0,0,
0,1449,0,0,0,0,0,0,0,0,0,1449,0,0,0,0,0,0,2210,2151,2151,0,0,1449,0,0,0,0,0,0,0,0,0,1449,0,0,0,0,0,0,
0,1449,0,0,0,0,0,0,0,0,0,1449,0,0,0,0,0,0,0,2151,0,0,0,1449,0,0,0,0,0,0,0,0,0,1449,0,0,0,0,0,0,
0,1449,1449,1449,1449,1449,0,1449,1449,1449,1449,1449,0,0,0,0,0,0,0,2151,0,0,0,1449,1449,1449,1449,1449,0,1449,1449,1449,1449,1449,0,0,0,0,0,0,
0,0,0,0,0,0,0,0,0,0,0,0,0,0,1030,0,0,0,0,0,0,0,0,0,1030,0,0,0,0,0,0,0,0,0,0,0,0,0,0,0,
0,0,0,0,0,0,0,0,0,0,0,0,0,0,1062,0,0,0,0,0,0,0,0,0,1062,0,0,0,0,0,0,0,0,0,0,0,0,0,0,0,
0,0,0,0,0,0,0,0,0,0,0,0,0,0,0,0,0,0,0,0,0,0,0,0,0,0,0,0,0,0,0,0,0,0,0,0,0,0,0,0,
0,0,0,0,0,0,0,0,0,0,0,0,0,0,0,0,0,0,0,0,0,0,0,0,0,0,0,0,0,0,0,0,0,0,0,0,0,0,0,0,
0,0,0,0,0,0,0,0,0,0,0,0,0,0,0,0,0,0,0,0,0,0,0,0,0,0,0,0,0,0,0,0,0,0,0,0,0,0,0,0,
0,0,0,0,0,0,0,0,0,0,0,0,0,0,0,0,0,0,0,0,0,0,0,0,0,0,0,0,0,0,0,0,0,0,0,0,0,0,0,0,
0,0,0,0,0,0,0,0,0,0,0,0,0,0,0,0,0,0,0,0,0,0,0,0,0,0,0,0,0,0,0,0,0,0,0,0,0,0,0,0,
0,0,0,0,0,0,0,0,0,0,0,0,0,0,0,0,0,0,0,0,0,0,0,0,0,0,0,0,0,0,0,0,0,0,0,0,0,0,0,0,
1351,1352,0,0,0,0,0,0,0,0,0,0,0,0,0,0,0,0,0,0,1351,1352,0,0,0,0,0,0,0,0,0,0,0,0,0,0,0,0,0,0,
1383,1384,0,0,0,0,0,0,1089,0,0,0,0,0,0,0,0,0,0,0,1383,1384,0,0,0,0,0,0,1089,0,0,0,0,0,0,0,0,0,0,0,
0,0,0,0,0,0,0,0,0,0,0,0,0,0,0,0,0,0,0,0,0,0,0,0,0,0,0,0,0,0,0,0,0,0,0,0,0,0,0,0,
0,0,0,0,0,0,0,0,0,0,0,0,0,0,0,0,0,0,0,0,0,0,0,0,0,0,0,0,0,0,0,0,0,0,0,0,0,0,0,0,
0,0,0,0,0,0,0,0,0,0,0,0,0,0,0,0,0,0,0,0,0,0,0,0,0,0,0,0,0,0,0,0,0,0,0,0,0,0,0,0
0,0,0,0,0,0,0,0,0,0,0,0,0,0,0,0,0,0,0,0,0,0,0,1026,1026,1026,1026,1026,0,0,0,0,0,0,1026,1026,1026,0,0,0,
0,0,0,0,0,0,0,0,0,0,0,0,0,0,0,0,0,0,0,0,0,0,0,0,0,0,0,1026,1026,0,0,0,0,1026,1026,0,0,0,0,0,
0,0,1026,0,0,0,0,0,0,0,0,0,0,0,0,0,0,0,0,0,0,0,0,0,0,0,0,0,0,0,0,0,0,0,0,0,0,0,0,0,
0,0,0,1026,1026,0,0,0,0,0,0,0,0,0,0,0,0,0,0,0,0,0,0,0,0,0,0,0,0,0,0,0,0,0,0,0,0,0,0,0,
0,0,1026,0,0,0,0,0,0,0,0,0,0,0,0,0,0,0,0,0,0,0,0,0,0,0,0,0,0,0,0,0,0,0,0,0,0,0,0,0,
0,0,1026,0,0,0,0,0,0,0,0,0,0,0,0,0,0,0,0,0,0,0,0,0,0,0,0,0,0,0,0,0,0,0,0,0,0,0,0,0,
0,0,0,1026,0,0,0,1026,1026,1026,0,0,0,0,0,0,0,0,0,0,0,0,0,0,0,0,0,0,0,0,0,0,0,0,0,0,0,0,0,0,
0,0,0,0,0,0,0,0,0,0,0,0,0,0,0,0,0,0,0,0,0,0,0,0,0,0,0,0,0,0,0,1026,0,0,0,0,1026,1026,0,0,
0,0,0,0,0,0,0,0,0,0,0,0,0,0,0,0,0,0,0,0,0,0,0,0,0,0,0,0,0,0,0,0,0,0,0,483,0,0,1026,0,
0,0,1671,1671,1671,1671,0,1671,1671,1671,1671,0,0,0,0,0,0,0,0,0,0,0,0,0,1672,1672,1672,1672,0,1672,1672,1672,1672,0,0,483,0,483,0,0,
0,0,1671,1671,1671,1671,0,1671,1671,1671,1671,0,0,0,0,0,0,0,0,0,0,0,0,0,1672,1672,1672,1672,0,1672,1672,1672,1672,0,0,483,483,483,0,0,
0,0,1671,1671,1671,1671,0,1671,1671,1671,1671,0,0,0,0,0,0,0,0,0,0,0,0,0,1672,1672,1672,1672,0,1672,1672,1672,1672,0,0,0,483,0,0,0,
0,0,0,0,0,0,0,0,0,0,0,0,483,483,0,0,0,0,0,0,0,0,0,0,0,0,0,0,0,0,0,0,0,0,0,0,483,0,0,1767,
0,0,1671,1671,1671,1671,0,1671,1671,1671,1671,0,483,483,483,0,0,0,0,0,0,0,0,0,1672,1672,1672,1672,0,1672,1672,1672,1672,0,0,0,0,1767,1767,1767,
0,0,1671,1671,1671,1671,0,1671,1671,1671,1671,0,483,483,483,0,0,0,0,0,0,0,0,0,1672,1672,1672,1672,0,1672,1672,1672,1672,0,0,0,0,0,1767,0,
0,0,1671,1671,1671,1671,0,1671,1671,1671,1671,0,0,483,483,0,0,0,0,0,0,0,0,0,1672,1672,1672,1672,0,1672,1672,1672,1672,0,0,0,0,0,0,0,
0,0,0,0,0,0,0,0,0,0,0,0,0,0,483,0,0,0,0,0,0,0,483,0,0,0,0,0,0,0,0,0,0,0,0,0,0,0,0,0,
0,0,0,0,0,0,0,0,0,0,0,0,0,0,0,0,0,0,0,0,0,483,483,0,0,0,0,0,0,0,0,0,0,0,0,1767,1767,1767,1767,1767,
0,0,1767,1767,0,0,1767,1767,1767,1767,1767,1767,1767,0,0,0,0,0,0,0,0,483,0,0,0,0,0,0,1767,1767,1767,1767,1767,1767,1767,1767,1767,1767,1767,1767,
0,0,1767,0,0,0,0,1767,1767,1767,1767,1767,1767,1767,1767,0,0,0,0,0,0,0,0,0,1767,1767,1767,1767,1767,1767,1767,1767,1767,1767,1767,1767,1767,1767,1767,0,
0,0,0,1767,1767,1767,0,0,0,0,0,0,1767,1767,1767,1767,0,0,1767,1767,0,0,0,1767,1767,0,0,1767,1767,1767,0,1767,1767,1767,1767,1767,1767,1767,0,0,
0,0,0,0,0,0,0,0,0,0,0,0,0,0,0,0,0,0,0,0,0,0,0,0,0,0,0,0,0,0,0,0,0,0,0,0,0,0,0,0,
0,0,0,0,0,0,0,0,0,0,0,0,0,0,0,0,0,0,0,0,0,0,0,0,0,0,0,0,0,0,0,0,0,0,0,0,0,0,0,0,
0,0,0,0,0,0,0,0,0,0,0,0,0,0,0,0,0,0,0,0,0,0,0,0,0,0,0,0,0,0,0,0,0,0,0,0,0,0,0,0,
0,0,0,1704,1704,1704,1704,1704,0,1704,1704,1704,1704,1704,0,0,0,0,0,0,0,0,0,1094,1094,1094,1094,1094,0,1094,1094,1094,1094,1094,0,0,0,0,0,0,
0,0,0,1704,1704,1704,1704,1704,0,1704,1704,1704,1704,1704,0,0,0,0,0,0,0,0,0,1094,1094,1094,1094,1094,0,1094,1094,1094,1094,1094,0,0,1767,1767,0,0,
0,0,0,0,0,0,0,0,0,0,0,0,0,0,0,0,0,1767,1767,0,0,0,0,0,0,0,0,0,0,0,0,0,0,0,0,0,1767,1767,1767,0,
0,0,0,1704,1704,1704,1704,1704,0,1704,1704,1704,1704,1704,0,0,0,1767,0,0,0,0,0,1094,1094,1094,1094,1094,0,1094,1094,1094,1094,1094,0,0,0,1767,1767,1767,
0,0,0,1704,1704,1704,1704,1704,0,1704,1704,1704,1704,1704,0,0,0,0,0,0,0,0,0,1094,1094,1094,1094,1094,0,1094,1094,1094,1094,1094,0,0,0,1767,1767,1767,
0,0,0,0,0,0,0,0,0,0,0,0,0,0,0,0,0,0,1767,1767,1767,1767,0,0,0,0,0,0,0,0,0,0,0,0,0,0,0,0,1767,1767