40
30
500
900
2339,2339,2339,2339,2339,2339,2339,2339,2339,2339,2339,2339,2339,2339,2339,2339,2339,2339,2339,2339,2339,2339,2339,2339,2339,2339,2339,2339,2339,2339,2339,2339,2339,2339,2339,2339,2339,2339,2339,2339,
2339,2339,2339,2339,2339,2339,2339,2307,2307,2307,2307,2307,2307,2339,2339,2339,2339,2339,2339,2339,2307,2307,2307,2307,2307,2307,2307,2339,2339,2339,2339,2339,2339,2339,2307,2307,2307,2307,2307,2307,
2339,2339,2339,2339,2307,2307,2307,2307,2307,2307,2307,2307,2307,2307,2307,2307,2307,2307,2307,2307,2307,2307,2307,2307,2307,2307,2307,2307,2307,2307,2307,2307,2307,2307,2307,2307,2307,2307,2307,2307,
2307,2307,2307,2307,2307,2307,2307,2307,2307,2307,2307,2307,2307,2307,2307,2307,2307,2307,2307,2307,2307,2307,2307,2307,2307,2307,2307,2307,2307,2307,2307,2307,2307,2307,2307,2307,2307,2307,2307,2307,
2307,2307,2307,2307,2307,2307,2307,2307,2275,2275,2275,2275,2275,2275,2275,2307,2307,2307,2307,2307,2275,2275,2275,2275,2275,2275,2275,2275,2307,2307,2307,2307,2307,2307,2275,2275,2275,2275,2275,2275,
2307,2307,2307,2307,2275,2275,2275,2275,2275,2275,2275,2275,2275,2275,2275,2275,2275,2275,2275,2275,2275,2275,2275,2275,2275,2275,2275,2275,2275,2275,2275,2307,2275,2275,2275,2275,2275,2275,2275,2275,
2275,2275,2275,2275,2275,2275,2275,2275,2275,2275,2275,2275,2275,2275,2275,2275,2275,2275,2275,2275,2275,2275,2275,2275,2275,2275,2275,2275,2275,2275,2275,2275,2275,2275,2275,2275,2275,2275,2275,2275,
2275,2275,2275,2275,2275,2275,2275,2275,2275,2275,2275,2275,2275,2275,2275,2275,2275,2275,2275,2275,2275,2275,2275,2275,2275,2275,2275,2275,2275,2275,2275,2275,2275,2275,2275,2275,2275,2275,2275,2275,
2275,2275,2275,2275,2275,2275,2275,2275,2275,2370,2370,2370,2370,2370,2370,2275,2275,2275,2275,2370,2370,2370,2370,2370,2370,2370,2370,2370,2370,2275,2275,2275,2275,2370,2370,2370,2370,2370,2370,2370,
2370,2370,2370,2370,2370,2370,2370,2370,2370,2370,2370,2370,2370,2370,2370,2370,2370,2370,2370,2370,2370,2370,2370,2370,2370,2370,2370,2370,2370,2370,2370,2370,2370,2370,2370,2370,2370,2370,2370,2370,
2370,2370,2370,2370,2370,2370,2370,2370,2370,2370,2370,2370,2370,2370,2370,2370,2370,2370,2370,2370,2370,2370,2370,2370,2370,2370,2370,2370,2370,2370,2370,2370,2370,2370,2370,2370,2370,2370,2370,2370,
727,728,727,728,727,728,727,728,727,728,727,727,728,727,727,727,727,727,727,727,727,727,727,727,727,727,727,727,727,727,727,727,727,727,727,727,727,727,727,728,
0,0,0,0,0,0,0,0,0,0,0,0,0,0,0,0,0,0,0,0,0,0,0,0,0,0,0,0,0,0,0,0,0,0,0,0,0,759,759,760,
499,1104,1104,1104,1104,1104,1104,1104,1104,1104,1104,1104,1104,1104,1104,1104,1104,1104,1104,1104,202,202,202,1104,1104,1104,1104,1104,1104,1104,1104,1104,1104,1104,1104,1104,1104,1104,1104,500,
1104,1104,1104,1104,1104,1104,1104,1104,1104,1104,1104,1104,1104,1104,1104,1104,1104,1104,1104,1104,202,202,202,1104,1104,1104,1104,1104,1104,1104,1104,1104,1104,1104,1104,1104,1104,1104,1104,1104,
1104,202,202,202,202,202,202,202,234,202,202,202,202,202,202,202,202,234,202,202,202,202,234,202,202,202,202,202,202,202,202,202,202,202,202,202,202,202,202,202,
1104,202,202,202,202,202,202,202,202,202,202,202,202,202,202,202,202,202,202,202,202,202,202,202,202,202,202,202,202,202,202,202,202,202,202,202,234,202,202,202,
1104,1104,1104,1104,1104,1104,1104,1104,1104,202,202,1104,1104,1104,1104,1104,1104,1104,1104,1104,202,202,202,1104,1104,1104,1104,1104,1104,1104,1104,1104,202,202,1104,1104,1104,1104,1104,1104,
1104,1104,1104,1104,1104,1104,1104,1104,1104,202,202,1104,1104,1104,1104,1104,1104,1104,1104,1104,202,202,202,1104,1104,1104,1104,1104,1104,1104,1104,1104,202,202,1104,1104,1104,1104,1104,1104,
1104,1104,1104,1104,1104,1104,1104,1104,1104,234,202,1104,1104,1104,1104,1104,1104,1104,1104,1104,202,202,202,1104,1104,1104,1104,1104,1104,1104,1104,1104,202,202,1104,1104,1104,1104,1104,1104,
531,1104,1104,1104,1104,1104,1104,1104,1104,202,202,1104,1104,1104,1104,1104,1104,1104,1104,1104,202,202,202,1104,1104,1104,1104,1104,1104,1104,1104,1104,202,202,1104,1104,1104,1104,1104,532,
338,338,338,338,338,338,338,338,338,338,338,338,338,338,338,338,338,338,338,338,338,338,338,338,338,338,338,338,338,338,338,338,338,338,338,338,338,338,338,370,
338,338,338,338,338,338,338,338,338,338,338,338,338,338,338,338,338,338,338,338,338,338,338,338,338,338,338,338,338,338,338,338,338,338,338,338,338,338,338,370,
338,338,338,338,338,338,338,338,338,338,338,338,338,338,338,338,338,338,338,338,338,338,338,338,338,338,338,338,338,338,338,338,338,338,338,338,338,338,338,370,
338,338,338,338,338,338,338,338,338,338,338,338,338,338,338,338,338,338,338,338,338,338,338,338,338,338,338,338,338,338,338,338,338,338,338,338,338,338,338,370,
338,338,338,338,338,338,338,338,338,338,338,338,338,338,338,338,338,338,338,338,338,338,338,338,338,338,338,338,338,338,338,338,338,338,338,338,338,338,338,370,
369,338,338,338,338,338,338,338,338,322,322,338,338,338,338,338,338,338,338,338,322,322,322,338,338,338,338,338,338,338,338,338,66,66,338,338,338,338,338,370,
369,338,338,338,338,338,338,338,338,322,322,338,338,338,338,338,338,338,338,338,322,322,322,338,338,338,338,338,338,338,338,338,66,66,338,338,338,338,338,370,
369,338,338,338,338,338,338,338,338,322,322,338,338,338,338,338,338,338,338,338,322,322,322,338,338,338,338,338,338,338,338,338,66,66,338,338,338,338,338,370,
322,322,322,322,322,322,322,322,322,322,322,322,322,322,322,322,322,322,322,322,322,322,322,322,322,322,322,322,322,322,322,322,322,322,322,322,322,322,322,322
0,0,0,0,0,0,0,0,0,0,0,0,0,0,0,0,0,0,0,0,0,0,0,0,0,0,0,0,0,0,0,0,0,0,0,0,0,0,0,0,
0,0,0,0,0,0,0,0,0,0,0,0,0,0,0,0,0,0,0,0,0,0,0,0,0,0,0,0,0,0,0,0,0,0,0,0,0,0,0,0,
0,0,0,0,0,0,0,0,0,0,0,0,0,0,0,0,0,0,0,0,0,0,0,0,0,0,0,0,0,0,0,0,0,0,0,0,0,0,0,0,
0,0,0,0,0,0,0,0,0,0,0,0,0,0,0,0,0,0,0,0,0,0,0,0,0,0,0,0,0,0,0,0,0,0,0,0,0,0,0,0,
0,0,0,0,0,0,0,0,0,0,0,0,0,0,0,0,0,0,0,0,0,0,0,0,0,0,0,0,0,0,0,0,0,0,0,0,0,0,0,0,
0,0,0,0,0,0,0,0,0,0,0,0,0,0,0,0,0,0,0,0,0,0,0,0,0,0,0,0,0,0,0,0,0,0,0,0,0,0,0,0,
0,0,0,0,0,0,0,0,0,0,0,0,0,0,0,0,0,0,0,0,0,0,0,0,0,0,0,0,0,0,0,0,0,0,0,0,0,0,0,0,
0,0,0,0,0,0,0,0,0,0,0,0,0,0,0,0,0,0,0,0,0,0,0,0,0,0,0,0,0,0,0,0,0,0,0,0,0,0,0,0,
0,0,0,0,0,0,0,0,0,0,0,0,0,0,0,0,0,0,0,0,0,0,0,0,0,0,0,0,0,0,0,0,0,0,0,0,0,0,0,0,
0,0,0,0,0,0,0,0,0,0,0,0,0,0,0,0,0,0,0,0,0,0,0,0,0,0,0,0,0,0,0,0,0,0,0,0,0,0,0,0,
0,0,0,0,0,0,0,0,0,0,0,0,0,0,0,0,0,0,0,0,0,0,0,0,0,0,0,0,0,0,0,0,0,0,0,0,0,0,0,0,
0,0,0,0,0,0,0,0,0,0,0,0,0,0,0,0,0,0,0,0,0,0,0,0,0,0,0,0,0,0,0,0,0,0,0,0,0,0,0,0,
759,760,759,760,759,760,759,760,759,760,759,759,760,759,759,759,759,759,759,759,759,759,759,759,759,759,759,759,759,759,759,759,759,759,759,759,759,0,0,0,
1950,1631,1631,1631,1631,1950,1950,0,0,0,1950,0,0,0,0,0,0,0,1439,0,0,1846,0,0,1439,0,0,0,0,1950,1950,0,0,1631,1631,1631,1631,0,1950,1950,
0,0,0,0,0,0,0,0,0,0,0,0,0,0,0,0,0,0,1471,0,0,1840,0,0,1471,0,0,1941,1942,0,0,0,0,0,0,0,0,0,0,0,
0,0,0,0,0,0,0,0,0,0,0,0,0,0,0,0,0,0,0,0,0,0,0,0,0,0,0,1973,1974,0,0,0,0,0,0,0,0,0,0,0,
0,0,0,0,0,0,0,0,0,0,0,0,0,0,0,0,0,0,0,0,0,0,0,0,0,0,0,0,0,0,0,0,0,0,0,0,0,0,0,1439,
1471,0,0,0,0,0,0,0,0,0,0,0,0,0,0,0,0,0,0,0,0,1913,0,0,0,0,0,0,0,0,0,0,0,0,0,0,0,0,0,1471,
1950,0,0,0,0,1950,1950,0,0,0,1950,1605,0,0,0,0,0,0,1605,0,0,0,0,0,1605,0,0,0,0,1950,1950,1605,0,0,0,0,0,0,1950,1950,
0,0,0,0,0,0,0,0,0,0,0,0,0,0,0,0,0,0,0,0,0,0,0,0,0,0,0,0,0,0,0,0,0,0,0,0,0,0,0,0,
1776,0,0,0,0,0,0,0,1776,0,0,1776,0,0,0,0,0,0,0,1776,0,0,0,1776,0,0,0,0,0,0,0,1776,0,0,1776,0,0,0,0,1776,
563,436,436,436,436,436,436,564,0,0,0,0,563,436,436,436,436,436,564,0,0,0,0,0,563,468,468,468,468,468,564,0,0,0,0,563,435,435,435,564,
563,436,436,436,436,436,436,564,0,0,0,0,563,436,436,436,436,436,564,0,0,0,0,0,563,468,468,468,468,468,564,0,0,0,0,563,435,435,435,564,
563,436,436,436,436,436,436,564,0,0,0,0,563,436,436,436,436,436,564,0,0,0,0,0,563,468,468,468,468,468,564,0,0,0,0,563,435,435,435,564,
563,436,436,436,436,436,436,564,0,0,0,0,563,436,436,436,436,436,564,0,0,0,0,0,563,468,468,468,468,468,564,0,0,0,0,563,435,435,435,564,
595,467,467,467,467,467,467,596,0,0,0,0,595,436,436,436,436,436,596,0,0,0,0,0,595,468,468,468,468,468,596,0,0,0,0,595,435,435,435,596,
0,0,0,0,0,0,0,1916,0,0,0,0,0,0,0,0,0,0,1914,0,0,0,0,0,1915,0,0,0,0,0,0,0,0,0,0,1916,0,0,0,0,
0,0,0,0,0,0,0,0,0,0,0,0,0,0,0,0,0,0,0,0,0,0,0,0,0,0,0,0,0,0,0,0,0,0,0,0,0,0,0,0,
0,0,0,0,0,0,0,0,0,0,0,0,0,0,0,0,0,0,0,0,0,0,0,0,0,0,0,0,0,0,0,0,0,0,0,0,0,0,0,0,
0,0,0,0,0,0,0,0,0,0,0,0,0,0,0,0,0,0,0,0,0,0,0,0,0,0,0,0,0,0,0,0,0,0,0,0,0,0,0,0
0,0,0,0,0,0,0,0,0,0,0,0,0,0,0,0,0,0,0,0,0,0,0,0,0,0,0,0,0,0,2276,2277,2278,2279,0,0,0,0,0,0,
0,0,0,0,0,0,0,0,0,0,0,0,0,0,0,0,0,0,0,0,0,0,0,0,0,0,0,0,0,0,0,0,0,0,0,0,0,0,0,0,
0,0,0,0,0,0,0,0,2340,2341,2342,2343,0,0,0,0,0,0,0,0,0,2340,2341,2342,2343,0,0,0,0,0,0,0,0,0,0,0,0,421,422,0,
0,0,0,0,0,0,0,0,0,0,0,0,0,0,0,0,0,0,0,0,0,0,0,0,0,0,0,0,0,0,2340,2341,2342,2343,0,0,0,453,454,0,
0,0,0,0,0,0,0,0,0,0,0,0,0,0,0,0,0,0,0,0,0,0,0,0,0,0,0,0,0,0,0,0,0,0,0,0,0,0,0,0,
0,0,0,0,0,0,0,0,0,0,0,0,0,0,0,0,0,0,0,0,0,0,0,2276,2277,2278,2279,0,0,0,0,0,0,0,0,0,0,0,0,0,
0,0,0,2276,2277,2278,2279,0,0,0,0,0,0,0,2276,2277,2278,2279,0,0,0,0,0,0,0,0,0,0,0,0,0,2276,2277,2278,2279,0,0,0,0,0,
0,0,0,0,0,0,0,0,0,0,0,0,0,0,0,0,0,0,0,0,0,0,0,0,0,0,0,0,0,0,0,0,0,0,0,0,0,0,0,0,
0,0,0,0,0,0,0,0,0,0,0,0,0,0,0,0,0,0,0,0,0,0,0,0,0,0,0,0,0,0,0,0,0,0,0,0,0,0,0,0,
0,0,1739,0,0,0,1739,0,0,0,1739,0,0,0,1739,0,0,0,1739,0,0,0,1739,0,0,0,1739,0,0,0,1739,0,0,0,1739,0,0,0,1739,0,
0,0,1771,0,0,0,1771,0,0,0,1771,0,0,0,1771,0,0,0,1771,0,0,0,1771,0,0,0,1771,0,0,0,1771,0,0,0,1771,0,0,0,1771,0,
1886,1886,1887,1887,1887,1886,1886,1887,1887,1887,1886,0,1809,0,0,1685,0,778,1972,1972,1784,1783,1784,1972,1972,778,1651,1685,0,1886,1886,1887,1887,1887,1887,1887,1887,1887,1886,1886,
1918,0,0,0,0,1918,1918,811,0,0,1918,0,1841,0,0,1717,0,810,0,0,0,1814,0,0,0,810,0,1717,0,1918,1918,0,0,0,0,811,0,0,1918,1918,
0,0,0,0,0,0,0,0,0,0,0,0,0,0,0,0,0,0,0,0,0,0,0,0,0,0,0,0,0,0,0,0,0,0,0,0,0,0,0,0,
0,0,0,0,0,0,0,0,0,0,0,0,0,0,0,0,0,0,0,0,0,0,0,0,0,0,0,0,0,0,0,0,0,0,0,0,0,0,0,0,
0,0,0,0,0,0,0,0,0,0,0,0,0,0,0,0,0,0,0,0,0,0,0,0,0,0,0,0,0,0,0,0,0,0,0,0,0,0,0,0,
1886,1887,1887,1887,1887,1886,1886,1887,1887,1887,1886,1541,0,0,0,0,0,0,1541,0,0,1881,0,0,1541,0,0,0,0,1886,1886,1541,1887,1887,1887,1887,1887,1887,1887,1886,
1918,0,0,0,0,1918,1918,0,0,0,1918,1573,0,0,0,0,0,0,1573,0,0,0,0,0,1573,0,0,0,0,1918,1918,1573,0,0,0,0,0,0,1918,1918,
0,0,0,0,0,0,0,0,0,0,0,0,0,0,0,0,0,0,0,0,0,0,0,0,0,0,0,0,0,0,0,0,0,0,0,0,0,0,0,0,
1744,1982,1983,1983,1983,1983,1983,1984,1744,0,0,1744,1982,1983,1983,1983,1983,1983,1984,1744,0,0,0,1744,1982,1983,1983,1983,1983,1983,1984,1744,0,0,1744,1982,1983,1983,1984,1744,
0,2014,2015,2015,2015,2015,2015,2016,0,0,0,0,2014,2015,2015,2015,2015,2015,2016,0,0,0,0,0,2014,2015,2015,2015,2015,2015,2016,0,0,0,0,2014,2015,2015,2016,0,
0,0,0,0,0,0,0,0,109,110,110,111,0,0,0,0,0,0,0,109,110,110,110,111,0,0,0,0,0,0,0,109,110,110,111,0,0,0,0,0,
0,0,0,0,0,0,0,0,109,110,110,111,0,0,0,0,0,0,0,109,110,110,110,111,0,0,0,0,0,0,0,109,110,110,111,0,0,0,0,0,
0,0,0,0,0,0,0,0,109,110,110,111,0,0,0,0,0,0,0,109,110,110,110,111,0,0,0,0,0,0,0,109,110,110,111,0,0,0,0,0,
0,0,0,0,0,0,0,0,109,110,110,111,0,0,0,0,0,0,0,109,110,110,110,111,0,0,0,0,0,0,0,109,110,110,111,0,0,0,0,0,
0,0,0,0,0,0,0,1884,109,110,110,111,0,0,0,0,0,0,1882,109,110,110,110,111,1883,0,0,0,0,0,0,109,110,110,111,1884,0,0,0,0,
0,0,0,0,0,0,0,0,0,0,0,0,0,0,0,0,0,0,0,0,0,0,0,0,0,0,0,0,0,0,0,0,0,0,0,0,0,0,0,0,
0,0,0,0,0,0,0,0,0,0,0,0,0,0,0,0,0,0,0,0,0,0,0,0,0,0,0,0,0,0,0,0,0,0,0,0,0,0,0,0,
0,0,0,0,0,0,0,0,0,0,0,0,0,0,0,0,0,0,0,0,0,0,0,0,0,0,0,0,0,0,0,0,0,0,0,0,0,0,0,0,
0,0,0,0,0,0,0,0,0,0,0,0,0,0,0,0,0,0,0,0,0,0,0,0,0,0,0,0,0,0,0,0,0,0,0,0,0,0,0,0
