40
30
500
900
73,73,73,73,73,73,73,73,73,73,73,73,73,73,73,577,577,577,577,577,577,577,577,577,577,577,577,577,577,577,577,73,73,73,73,73,73,73,73,73,
73,73,73,73,73,73,73,73,73,73,73,73,73,73,577,577,577,577,577,577,577,577,577,577,577,577,577,577,577,577,73,73,73,73,73,73,73,73,73,73,
73,73,73,73,73,73,73,73,73,73,73,73,73,73,577,577,577,577,577,577,577,577,577,577,577,577,577,577,577,577,73,73,73,73,73,73,73,73,73,73,
73,73,73,73,73,73,73,73,73,73,73,73,73,577,577,577,577,577,577,577,577,577,577,577,577,577,577,577,577,577,73,73,73,73,73,73,73,73,73,73,
73,73,73,73,73,73,73,73,73,73,73,73,577,577,577,577,577,577,577,577,577,577,577,577,577,577,577,577,577,577,73,73,73,73,73,73,73,73,73,73,
73,73,73,73,73,73,73,73,73,73,73,577,577,73,577,577,577,577,577,577,577,577,577,577,577,577,577,577,577,577,73,73,73,73,73,73,73,73,73,73,
73,73,73,73,73,73,73,73,73,73,577,577,577,577,577,577,577,577,577,577,577,577,577,577,577,577,577,577,577,73,73,73,73,73,73,73,73,73,73,73,
73,73,73,73,73,73,73,73,577,577,577,577,577,577,577,577,577,577,577,577,577,577,577,577,577,577,577,577,577,73,73,73,73,73,73,73,73,73,73,73,
73,73,73,73,73,73,577,577,577,577,577,577,577,577,577,577,577,577,577,577,577,577,577,577,577,577,577,577,73,73,73,73,73,73,73,73,73,73,73,73,
73,73,73,73,577,577,577,577,577,577,577,577,577,577,577,577,577,577,577,577,577,577,577,577,577,577,577,73,73,73,73,73,73,73,73,73,73,73,73,73,
73,73,73,577,577,577,577,577,577,577,577,577,577,577,577,577,577,577,577,577,577,577,577,577,577,577,73,73,73,73,73,73,73,73,73,73,73,73,73,73,
73,73,577,577,577,577,577,577,577,577,577,577,577,577,577,577,577,577,577,577,577,577,577,577,577,73,73,73,73,73,73,73,73,73,73,73,73,73,73,73,
577,577,577,577,577,577,577,577,577,577,577,577,577,577,577,577,577,577,577,577,577,577,577,577,73,73,73,73,73,73,73,73,73,73,73,73,73,73,73,73,
577,577,577,577,769,769,769,769,769,769,769,769,769,769,769,769,769,769,577,577,577,577,73,73,73,73,73,73,73,73,73,73,73,73,73,73,73,73,73,73,
577,577,577,577,577,577,577,577,577,577,577,577,577,577,577,577,577,577,577,577,577,73,73,73,73,73,73,73,73,73,73,73,73,73,73,73,73,73,73,73,
577,577,577,577,577,577,577,577,577,577,577,577,577,577,577,577,577,577,577,577,73,73,73,73,73,73,73,73,73,73,73,73,73,73,73,73,73,73,73,73,
577,577,577,577,577,577,577,577,577,577,577,577,577,577,577,577,577,577,577,73,73,73,73,73,73,73,73,73,73,73,73,73,73,73,73,73,73,73,73,73,
577,577,577,577,577,577,577,577,577,577,577,577,577,577,577,577,577,73,73,73,73,73,73,73,73,73,73,73,73,73,73,73,73,73,73,73,73,73,73,73,
577,577,577,577,577,577,577,577,577,577,577,577,577,577,577,577,73,73,73,73,73,73,73,73,73,73,73,73,73,73,73,73,73,73,73,73,73,73,73,73,
577,577,577,577,577,577,577,577,577,577,577,577,577,577,73,73,73,73,73,73,73,73,73,73,73,73,73,73,73,73,73,73,73,73,73,73,73,73,73,73,
577,577,577,577,577,577,577,577,577,577,577,577,577,73,73,73,73,73,73,73,73,73,73,73,73,73,73,73,73,73,73,73,73,73,73,73,73,73,73,73,
577,577,577,577,577,577,577,577,577,577,577,73,73,73,73,73,73,73,73,73,73,73,73,73,73,73,73,73,73,577,577,577,73,577,577,577,73,73,73,73,
577,577,577,577,577,577,577,577,577,73,73,73,73,73,73,73,73,73,73,73,73,73,73,73,73,73,73,73,73,577,577,577,73,577,577,577,73,73,73,73,
577,577,577,577,577,577,577,73,73,73,73,73,73,73,73,73,73,73,73,73,73,73,73,73,73,73,73,73,73,73,73,73,73,73,73,73,73,73,73,73,
577,577,577,577,577,73,73,73,73,73,73,73,73,73,73,73,73,73,73,73,73,73,73,73,73,73,73,73,73,577,577,577,73,577,577,577,73,73,73,73,
577,577,577,73,73,73,73,73,73,73,73,73,73,73,73,73,73,73,73,73,73,73,73,73,73,73,73,73,73,577,577,577,73,577,577,577,73,73,73,73,
577,73,73,73,73,73,73,73,73,73,73,73,73,73,73,73,73,73,73,73,73,73,73,73,73,73,73,73,73,73,73,73,73,73,73,73,73,73,73,73,
73,73,73,73,73,73,73,73,73,73,73,73,73,73,73,73,73,73,73,73,73,73,73,73,73,73,73,73,73,73,73,73,73,73,73,73,73,73,73,73,
73,73,73,73,73,73,73,73,73,73,73,73,73,73,73,73,73,73,73,73,73,73,73,73,73,73,73,73,73,73,73,73,73,73,73,73,73,73,73,73,
73,73,73,73,73,73,73,73,73,73,73,73,73,73,73,73,73,73,73,73,73,73,73,73,73,73,73,73,73,73,73,73,73,73,73,73,73,73,73,73
1505,1506,0,0,0,1505,1506,0,1505,1506,1505,1506,0,0,0,0,0,0,0,0,2084,2085,2116,2116,2116,2118,2119,0,0,0,0,0,0,0,0,0,0,0,0,0,
1537,1538,1505,1506,1505,1475,1476,1506,1537,1538,1537,1538,0,0,0,0,0,0,0,2083,2085,2116,2116,2116,2116,2118,0,0,0,0,0,0,0,0,0,0,0,0,0,0,
0,0,1537,1538,1537,1507,1508,1507,1506,1505,1506,0,0,0,0,2082,2082,2083,2084,2148,2148,2148,2116,2116,2150,2150,0,0,0,0,0,0,0,0,0,0,0,0,0,0,
1505,1506,1505,1506,1505,1475,1476,1475,1476,1475,1476,1506,0,0,2082,2083,2083,2083,2084,2148,2148,2148,2116,2116,2150,0,0,0,0,0,0,0,0,0,0,0,0,0,0,0,
1537,1507,1508,1538,1537,1507,1508,1538,1537,1538,1537,1538,0,0,2083,2147,2147,2147,2148,2148,2148,2148,2116,2150,2150,0,0,0,0,0,0,0,0,0,0,0,0,0,0,0,
0,1537,1538,0,0,1537,1538,0,0,0,0,0,0,2083,2147,2147,2147,2148,2148,2148,2148,2148,2150,0,0,0,0,0,0,0,0,0,0,0,0,0,0,0,0,0,
0,0,0,0,0,0,0,0,0,0,0,0,2050,2083,2147,2148,2148,2148,2117,2117,2117,2150,2150,0,0,0,0,0,0,0,0,0,0,0,0,0,0,0,0,0,
0,0,0,0,0,0,0,0,0,0,0,2050,2083,2147,2147,2148,2148,2148,2117,2117,2117,2182,0,0,0,0,0,0,0,0,0,0,0,0,0,0,0,0,0,0,
0,0,0,0,0,0,0,0,0,0,2083,2083,2147,2148,2148,2148,2148,2117,2117,2117,2150,2182,0,0,0,0,0,0,0,0,0,0,0,0,0,0,0,0,0,0,
0,0,0,0,0,0,0,0,2050,2050,2083,2147,2148,2148,2148,2148,2148,2148,2150,2182,0,0,0,0,0,0,0,0,0,0,0,0,0,0,0,1580,1581,0,0,0,
0,0,0,0,0,0,2050,2050,2083,2083,2147,2148,2148,2148,2148,2148,2148,2150,2182,0,0,0,0,0,0,0,0,0,0,0,0,0,0,0,0,1612,1613,0,0,0,
0,0,0,0,2050,2050,2083,2083,2083,2179,2148,2148,2148,2148,2148,2148,2182,0,0,0,0,0,0,0,0,0,0,0,0,0,0,0,0,0,0,0,0,0,0,0,
0,0,0,0,2050,2146,2083,2147,2148,2149,2148,2148,2149,2148,2148,2182,0,0,0,0,0,0,0,0,0,0,0,0,0,0,0,0,0,0,0,0,0,0,0,0,
0,0,0,0,0,0,0,0,0,0,0,0,0,0,0,0,0,0,0,0,0,0,0,0,0,0,0,0,0,0,0,0,0,0,0,0,0,0,0,0,
0,2178,2178,2178,2147,2148,2148,2116,2116,2148,2148,2118,2087,2087,0,0,0,0,0,0,0,0,0,0,0,0,0,0,0,0,0,0,0,0,0,0,0,0,0,0,
2178,2178,2083,2084,2084,2116,2116,2116,2148,2148,2118,2118,2087,0,0,0,0,0,0,0,0,0,0,0,0,0,0,0,0,0,0,0,0,0,0,0,0,0,0,0,
2178,2083,2147,2116,2116,2116,2117,2117,2214,2214,2119,2119,0,0,0,0,0,0,0,0,0,0,0,0,0,0,0,0,0,0,0,0,0,0,1579,1581,0,0,0,0,
2083,2147,2116,2116,2117,2117,2117,2214,2214,2151,0,0,0,0,0,0,0,0,0,0,0,0,0,0,0,0,0,0,0,0,0,0,0,0,1612,1613,0,0,0,0,
2116,2116,2116,2117,2117,2150,2183,2183,2151,0,0,0,0,0,0,0,0,0,0,0,0,0,0,0,0,0,0,0,0,0,0,0,0,0,0,0,0,0,0,0,
2116,2116,2117,2117,2150,2183,2183,0,0,0,0,0,0,0,0,0,0,0,0,0,0,0,0,0,0,0,0,0,0,0,0,0,0,0,0,0,0,0,0,0,
2149,2149,2150,2215,2215,2215,0,0,0,0,0,0,0,0,0,0,0,0,0,0,0,0,0,0,0,0,0,0,1513,1450,1450,1450,1450,1450,1450,1450,1482,0,0,0,
2180,2181,2215,2215,0,0,0,0,0,0,0,0,0,0,0,0,0,0,0,0,0,0,0,0,0,0,0,0,1449,0,0,0,0,0,0,0,1482,0,0,0,
2212,2215,2215,0,0,0,0,0,0,0,0,0,0,0,0,0,0,0,0,0,0,1351,1352,1156,0,0,0,0,1449,0,0,0,0,0,0,0,1482,0,0,0,
2215,2246,0,0,0,0,0,0,0,0,0,0,0,0,0,0,0,0,0,0,1351,1415,1416,1352,1156,0,0,0,1449,0,0,0,0,0,0,0,0,0,0,0,
2246,0,0,0,0,0,0,0,0,0,0,0,0,0,0,0,0,0,0,0,1383,1447,1448,1384,1156,0,0,0,1449,0,0,0,0,0,0,0,1482,0,0,0,
0,0,0,0,0,0,0,0,0,0,0,0,0,0,0,0,0,0,1351,1352,0,1383,1384,1351,1352,1156,0,0,1449,0,0,0,0,0,0,0,1482,0,1569,1570,
0,0,0,0,0,0,0,0,0,0,0,0,0,0,0,1351,1352,1351,1415,1416,1352,0,0,1383,1384,1156,0,0,1513,1450,1450,1450,1450,1450,1450,1450,1514,0,1601,1602,
0,0,0,0,0,0,0,0,0,0,0,0,0,0,0,1383,1384,1383,1384,1383,1384,0,1156,0,0,0,0,0,1742,0,0,0,994,0,0,0,0,0,0,0,
0,0,0,0,0,0,0,0,0,0,0,0,0,1477,1478,0,0,0,0,0,1351,1352,0,0,1156,0,0,0,1774,0,0,0,0,0,0,0,0,0,0,0,
0,0,0,0,0,0,0,0,0,0,0,0,0,0,0,0,0,0,0,1156,1383,1384,1156,0,0,1412,0,0,0,0,0,0,0,0,0,0,0,0,0,0
0,0,0,0,0,0,0,0,0,0,0,0,0,0,0,0,0,0,0,0,0,1191,1190,0,0,0,0,0,0,1026,0,0,0,0,0,0,0,1961,0,0,
0,0,0,0,0,0,0,0,0,0,0,0,0,0,0,0,0,0,0,0,0,1191,1190,0,0,0,0,1026,0,0,0,0,1027,1026,0,1219,0,1961,0,0,
0,0,0,0,0,0,0,0,0,0,0,0,1285,0,0,0,0,0,0,0,0,0,0,0,0,0,0,1026,0,0,0,0,1027,1026,0,1217,0,1961,0,0,
0,0,0,0,0,0,0,0,0,0,0,0,1317,0,0,0,0,0,0,0,0,0,1190,0,0,1026,0,1026,0,0,0,0,1026,1026,1219,0,0,1961,0,0,
0,0,0,0,0,0,0,0,0,0,0,0,1026,0,0,0,0,0,0,1191,0,0,0,0,0,0,0,1026,1026,0,0,0,1026,1219,1219,0,0,1961,0,0,
0,0,0,0,0,0,0,0,0,0,0,0,1026,0,0,0,0,0,0,1191,0,0,0,0,0,0,0,1026,0,0,0,0,1026,1219,0,0,0,1961,0,0,
0,0,0,1285,0,0,0,0,0,0,0,0,0,0,1192,0,0,1191,0,0,0,1190,0,0,0,0,0,0,0,0,0,1027,1026,0,0,0,0,1961,0,0,
0,0,0,1317,0,0,0,0,0,1026,0,0,0,1192,0,0,0,1191,1190,0,0,0,0,0,0,0,0,0,0,0,0,1026,0,0,0,0,0,1961,0,0,
0,0,0,0,0,0,0,0,0,1026,0,0,0,1192,0,0,0,1190,1190,0,1190,0,0,0,1026,0,0,0,0,0,1026,1026,1217,1217,0,0,0,1961,0,0,
0,0,0,0,0,0,0,0,0,0,0,0,0,0,0,1190,0,0,1191,0,0,0,0,0,0,0,0,0,0,1026,1026,0,0,0,0,0,0,1961,0,0,
0,0,0,0,0,0,0,0,0,0,0,0,0,0,1192,0,0,0,0,0,0,0,0,0,0,0,0,0,0,1026,0,0,0,0,0,0,0,1961,0,0,
0,0,0,748,0,0,0,0,0,0,0,0,0,1192,0,0,0,0,752,0,0,1026,0,0,1026,0,0,0,1026,0,0,1026,1026,0,0,0,0,1961,0,0,
0,0,0,780,781,782,782,782,782,782,782,782,782,782,782,782,782,783,784,0,0,0,0,0,0,0,0,1026,1219,1219,1026,1026,0,0,0,0,0,1961,0,0,
0,0,0,812,813,814,814,814,814,814,814,814,814,814,814,814,814,815,816,0,0,0,0,0,0,0,1026,0,0,0,1027,0,0,0,0,0,0,1961,0,0,
0,0,0,844,845,846,846,846,846,846,846,846,846,846,846,846,846,847,848,0,0,0,0,0,1218,1218,1218,0,0,1026,0,0,0,0,0,0,0,1997,1931,1931,
0,0,0,0,1192,1192,0,0,1191,1190,1190,0,0,0,0,0,1026,1026,0,0,0,0,0,1220,1218,0,0,0,1026,0,0,0,0,0,0,0,0,1961,0,0,
0,0,0,0,0,0,1191,1190,1190,0,0,0,0,0,0,0,0,0,0,0,0,1220,1218,1218,0,0,1026,1026,1027,0,0,0,0,0,0,0,0,1961,0,0,
0,0,0,1191,0,0,0,0,0,0,0,0,0,0,0,0,0,0,0,0,0,0,0,0,0,0,0,1028,0,0,0,0,0,0,0,0,0,1961,0,0,
0,0,0,1191,1191,0,0,0,0,0,0,0,0,1026,0,0,0,0,0,0,0,1219,0,0,0,0,0,0,0,0,0,0,0,0,0,0,0,1993,0,0,
0,1192,0,0,0,0,0,0,0,0,0,0,0,0,0,0,1027,1026,1026,1026,1026,1219,1217,1026,0,0,0,0,0,0,0,0,0,0,0,0,0,0,0,0,
0,1192,0,0,0,0,0,0,0,0,0,0,0,0,1026,1026,1026,1026,0,1026,0,1217,1217,0,0,0,0,1028,0,0,0,0,0,0,0,0,0,0,0,0,
0,0,0,0,0,0,0,0,0,0,0,0,0,0,0,0,0,0,1026,0,0,0,0,0,0,0,0,0,0,1094,1094,1094,0,1093,1093,1093,0,0,0,0,
0,0,0,0,0,0,0,0,0,0,0,0,0,1027,0,0,1026,0,0,0,0,0,0,0,0,0,0,0,0,1094,1094,1094,1634,1093,1093,1093,0,0,0,0,
0,0,0,0,0,0,0,0,0,0,0,0,0,0,0,1026,0,0,0,0,0,0,0,0,0,0,0,0,0,0,0,0,1666,0,0,0,0,0,0,0,
0,0,0,0,0,0,0,0,0,0,1026,1026,1218,0,0,1217,0,1219,1219,0,0,0,0,0,0,0,0,0,0,1095,1095,1095,0,1096,1096,1096,0,0,0,0,
0,0,0,0,0,0,0,483,483,0,1026,0,1026,0,0,0,0,0,0,0,1123,0,0,0,0,0,0,0,0,1095,1095,1095,0,1096,1096,1096,0,0,0,0,
0,0,0,0,0,0,483,0,0,0,0,0,0,0,0,0,0,0,0,0,0,1123,0,0,0,0,0,0,0,0,0,0,0,0,0,0,0,0,0,0,
0,0,0,515,516,483,0,1218,0,0,1026,0,0,0,0,0,0,0,0,0,0,1187,0,0,0,0,0,1374,0,0,0,0,0,0,0,0,0,0,0,0,
0,0,0,547,548,483,0,0,0,0,1219,1124,1124,0,0,0,0,0,1123,1123,0,0,0,0,0,0,0,1406,0,1342,0,0,0,0,0,0,0,0,0,0,
0,0,0,0,0,0,0,0,0,0,0,1124,1124,1124,1124,1124,0,1155,0,0,0,0,0,0,0,0,0,0,0,0,0,0,0,0,0,0,0,0,0,0