40
30
20
500
73,73,73,73,73,73,73,73,73,73,73,73,577,577,577,577,73,73,73,73,73,73,73,73,73,73,73,73,73,73,73,73,73,73,73,73,577,577,73,73,
73,73,73,73,73,73,73,73,577,577,577,577,73,73,73,577,577,577,577,577,73,73,73,73,73,73,73,73,73,73,73,73,73,73,577,73,73,577,73,73,
73,73,73,73,73,73,73,577,577,73,73,73,73,73,73,73,73,73,73,577,577,73,73,73,73,73,73,73,73,73,73,73,73,577,577,577,577,577,577,73,
73,73,73,73,73,73,577,577,73,73,73,73,73,73,73,73,73,73,73,73,577,577,73,73,73,73,73,73,73,73,577,577,73,73,577,577,577,73,577,73,
73,73,73,73,73,577,577,73,73,73,73,73,73,73,73,73,73,73,73,73,73,577,73,73,73,73,73,73,73,73,577,577,577,73,73,577,577,577,577,577,
73,73,73,73,577,577,73,73,73,73,73,577,577,577,577,577,73,73,73,73,73,577,73,73,73,73,73,577,73,73,73,577,577,577,577,73,577,577,73,577,
73,73,73,73,577,73,73,73,73,73,73,577,577,577,577,577,73,73,73,73,577,577,73,73,73,73,577,577,73,73,73,73,73,577,577,73,73,577,73,577,
73,73,73,577,73,73,73,73,73,73,577,577,577,577,577,73,73,73,577,577,577,73,73,73,73,73,577,577,577,73,73,73,73,73,577,577,73,577,73,577,
73,73,73,577,73,73,73,73,73,73,577,577,577,577,73,73,73,73,73,73,73,73,73,73,73,73,577,577,577,577,73,73,73,73,577,577,577,577,577,577,
73,73,73,577,73,73,73,73,73,73,73,73,73,73,73,73,73,577,577,577,73,73,73,73,73,73,73,577,577,577,577,577,73,73,73,577,577,577,577,577,
73,73,73,577,73,73,73,73,73,73,73,73,73,73,73,73,73,73,73,577,73,73,73,73,73,73,73,577,577,577,577,577,577,577,577,577,577,577,577,577,
73,73,73,577,73,73,73,73,73,73,73,73,73,73,73,73,73,73,73,577,73,73,73,73,73,73,73,73,577,577,577,577,577,577,577,577,577,577,577,577,
73,73,73,577,73,73,73,73,73,73,73,73,73,73,73,73,73,73,73,577,73,73,73,73,73,73,0,0,73,577,577,577,577,577,577,577,577,577,577,73,
73,73,73,577,73,73,73,73,73,73,73,73,73,73,73,73,73,73,577,577,73,73,73,73,0,0,0,0,73,73,577,577,577,577,577,577,577,577,577,73,
73,73,73,577,73,73,73,73,73,73,73,73,73,73,73,577,577,577,577,73,73,73,0,0,0,0,0,0,73,73,577,577,577,577,577,577,577,577,73,73,
73,73,577,577,73,73,73,73,73,73,73,73,73,73,577,577,73,73,73,73,0,0,0,0,0,0,0,73,73,73,577,577,577,577,577,577,577,577,73,73,
73,73,577,73,73,73,73,73,73,73,73,73,73,577,577,73,73,73,0,0,0,0,0,0,0,0,0,73,73,73,577,577,577,577,577,577,577,73,73,73,
73,577,577,73,73,73,73,73,73,73,73,73,577,577,73,73,73,0,0,0,0,0,0,0,0,0,0,73,73,577,577,577,577,577,577,577,73,73,73,73,
73,577,73,73,73,73,73,73,73,73,73,73,577,73,73,0,0,0,0,0,0,0,0,0,0,0,73,73,577,577,577,577,577,577,577,73,73,73,73,73,
577,577,73,73,73,73,73,73,73,73,73,73,577,73,73,0,0,0,0,0,0,0,0,0,0,73,73,577,577,577,577,577,577,73,73,73,73,73,73,73,
577,73,73,73,73,73,73,73,73,73,73,73,577,577,0,0,0,0,0,0,0,0,0,0,73,73,577,577,577,577,577,577,73,73,73,73,73,73,73,73,
577,73,73,73,73,73,577,577,577,577,577,577,577,577,0,0,0,0,0,0,0,0,0,73,73,577,577,577,577,577,73,73,73,73,73,73,73,73,73,73,
577,73,73,73,73,73,577,577,577,577,577,577,577,577,73,0,0,0,0,0,0,73,73,73,577,577,577,577,73,73,73,73,73,73,73,73,73,73,73,73,
577,73,73,73,73,73,73,577,577,577,577,73,73,577,577,0,0,0,0,0,0,73,577,577,577,577,577,73,73,73,73,73,73,73,73,73,73,73,73,73,
577,73,73,73,73,73,73,73,577,577,73,73,73,577,577,73,0,0,0,0,73,577,577,577,577,577,73,73,73,73,73,73,73,73,73,73,73,73,73,73,
577,73,73,73,73,73,73,73,73,73,73,73,73,577,577,73,73,73,0,0,577,577,577,577,73,73,73,73,73,73,73,73,73,73,73,73,73,73,73,73,
73,73,73,73,73,73,73,73,73,73,73,73,73,73,577,73,73,73,73,577,577,577,577,73,73,73,73,73,73,73,73,73,73,73,73,73,73,73,73,73,
73,73,73,73,73,73,73,73,73,73,73,73,73,73,577,73,73,73,577,577,577,577,577,73,73,73,73,73,73,73,73,73,73,73,73,73,73,73,73,73,
73,73,73,73,73,73,73,73,73,73,73,73,73,73,577,577,73,577,577,577,577,577,73,73,73,73,73,73,73,73,73,73,73,73,73,73,73,73,73,73,
73,73,73,73,73,73,73,73,73,73,73,73,73,73,577,577,577,577,577,577,577,73,73,73,73,73,73,73,73,73,73,73,73,73,73,73,73,73,73,73
0,0,0,0,0,0,0,0,0,1733,0,0,0,0,0,1733,1733,0,0,0,0,0,0,0,0,0,0,0,0,0,0,0,0,0,0,0,0,0,0,0,
0,0,0,0,1733,0,0,0,0,0,0,0,0,0,0,0,0,0,0,0,0,0,0,0,0,0,0,0,0,0,0,0,0,0,0,0,0,0,0,0,
0,0,0,0,0,0,0,0,0,0,0,0,0,0,0,0,0,0,0,0,0,0,0,1733,0,0,0,0,0,0,0,0,0,0,0,0,0,0,0,0,
0,0,0,0,0,1351,1352,0,0,0,0,0,0,0,0,0,0,0,0,0,0,0,0,0,0,0,0,0,0,0,0,0,0,0,0,0,0,0,0,0,
0,0,0,0,0,1383,1384,0,0,0,0,0,0,0,0,0,0,0,0,0,0,0,0,0,0,0,1347,0,0,0,0,0,0,0,0,0,0,0,0,0,
0,0,0,0,0,0,0,0,0,0,0,0,0,0,0,0,0,0,0,0,0,0,1351,1352,0,0,0,0,0,0,1351,1352,0,0,0,0,0,0,0,0,
0,0,0,0,0,0,0,0,0,0,0,0,1347,0,0,0,0,0,0,1733,0,0,1383,1384,0,0,0,0,0,0,1383,1384,0,0,0,1351,1352,0,0,0,
0,0,0,0,0,0,0,0,0,0,0,0,0,0,0,0,0,0,0,0,0,0,0,0,0,0,0,0,0,0,0,0,0,0,0,1383,1384,0,0,0,
0,0,0,0,0,0,0,0,0,0,0,0,0,0,0,0,0,0,0,0,0,0,0,0,0,0,0,0,0,0,0,0,0,0,0,0,0,0,0,0,
0,0,0,0,0,0,0,0,0,0,0,0,0,0,0,1351,1352,0,0,0,0,0,0,0,0,0,0,0,0,0,0,0,0,0,0,0,0,0,0,0,
0,0,0,0,0,1347,0,0,0,0,0,0,0,0,1351,1415,1384,0,0,0,0,0,0,0,0,0,0,0,0,0,0,0,0,0,0,0,0,0,0,0,
0,0,0,0,0,0,0,0,0,0,0,0,0,0,1383,1384,0,0,0,0,0,0,0,0,0,0,0,0,0,0,0,0,0,0,0,0,0,0,0,0,
0,0,0,1733,0,0,0,0,0,0,0,0,0,0,0,0,0,0,0,0,0,0,0,0,0,0,2146,2146,0,0,0,0,0,0,0,0,0,0,0,0,
0,0,0,0,0,0,0,0,0,0,0,0,0,0,0,0,0,0,0,0,1733,0,0,0,2146,2146,2146,2146,1347,0,0,0,0,0,0,0,0,0,0,0,
0,0,0,0,0,0,0,0,0,0,1351,1352,0,0,0,0,0,0,0,0,0,0,2146,2085,2084,2085,2146,2146,0,1347,0,0,0,0,0,0,0,0,0,0,
0,0,1347,0,0,0,0,0,0,0,1383,1384,0,0,0,0,0,0,0,0,2146,2114,2084,2116,2116,2117,2146,0,0,0,0,0,0,0,0,0,0,0,0,0,
0,0,0,0,0,0,0,0,0,0,1351,1352,0,0,0,0,0,0,2146,2146,2114,2115,2116,2117,2117,2148,2146,0,0,0,0,0,0,0,0,0,1733,0,0,0,
0,0,0,0,0,0,0,0,0,0,1383,1384,0,0,0,0,0,2146,2114,2115,2115,2115,2148,2148,2148,2149,2146,0,0,0,0,0,0,0,0,0,0,0,0,0,
0,0,0,0,0,0,0,0,0,0,0,0,0,0,0,2146,2114,2115,2115,2115,2116,2148,2148,2148,2148,2151,0,0,0,0,0,0,0,0,1351,1352,0,0,0,0,
0,0,0,0,0,0,0,0,0,0,0,0,0,0,0,2114,2115,2115,2116,2116,2148,2148,2148,2148,2151,0,0,0,0,0,0,0,0,0,1383,1384,0,0,0,0,
0,0,0,0,0,0,0,0,0,0,0,0,0,0,2179,2114,2115,2116,2148,2148,2148,2148,2149,2151,0,0,0,0,0,0,0,0,0,0,0,0,0,0,0,0,
0,0,0,0,1347,1347,0,0,0,0,0,0,0,0,2179,2179,2148,2148,2148,2148,2149,2146,2151,0,0,0,0,0,0,0,0,0,0,0,0,0,0,0,0,0,
0,0,0,0,0,0,0,0,0,0,0,0,0,0,0,2179,2179,2149,2149,2146,2151,1351,1352,0,0,0,0,0,0,0,0,0,0,0,0,0,0,0,0,0,
0,0,0,0,0,0,0,0,0,0,0,0,0,0,0,2179,2179,2180,2150,2150,2151,1383,1384,0,0,0,0,0,0,0,0,0,0,0,0,0,0,0,0,0,
0,0,1733,1733,0,1351,1352,0,0,0,0,0,0,0,0,0,2179,2211,2211,2211,0,0,0,0,0,0,0,0,0,0,0,0,0,0,0,0,1351,1352,0,0,
0,0,0,1733,0,1383,1384,0,0,0,0,0,0,0,0,1347,1347,0,2211,2211,0,0,0,0,0,0,0,0,0,0,0,0,0,1347,0,0,1383,1384,0,0,
0,0,0,0,0,0,0,0,0,0,0,0,0,0,0,0,0,0,0,0,0,0,0,0,0,0,0,0,0,0,0,0,0,0,0,0,0,0,0,0,
0,0,0,0,0,0,0,0,0,0,0,0,0,0,0,0,0,0,0,0,0,0,0,1347,0,0,1351,1352,0,0,0,0,0,0,0,0,0,0,0,0,
0,0,0,0,0,1733,0,0,0,0,0,0,0,0,0,0,0,0,0,0,0,0,0,0,0,0,1383,1384,0,0,0,0,0,0,0,0,0,0,0,0,
0,0,0,0,0,0,0,0,0,0,0,0,0,0,0,0,0,0,0,0,0,0,0,0,0,0,0,0,0,0,0,0,0,0,0,0,0,0,0,0
0,0,0,0,0,0,0,0,0,0,0,0,0,0,0,0,0,0,0,0,0,0,0,0,0,0,0,0,0,0,0,0,0,0,0,0,0,0,0,0,
0,0,0,0,0,0,0,0,0,0,0,0,0,0,0,0,0,0,0,0,0,0,0,0,0,0,0,0,0,0,0,0,0,0,0,0,0,0,0,0,
0,0,0,0,0,0,0,0,0,0,0,0,0,0,0,0,0,0,0,0,0,0,0,0,0,0,0,0,0,0,0,1285,1285,1285,0,0,0,0,0,0,
0,0,0,0,0,0,0,0,0,0,0,0,0,1285,0,0,0,0,0,0,0,0,0,0,0,0,0,0,0,0,0,1317,1317,1317,1285,0,0,0,0,0,
0,0,0,0,0,0,0,0,0,0,0,0,0,1285,0,0,0,0,0,0,0,0,0,0,0,0,0,0,0,0,0,0,0,0,1317,0,0,0,0,0,
0,0,0,0,0,0,0,0,0,0,0,0,0,1317,0,0,0,0,0,0,0,0,0,0,0,0,0,0,0,0,0,0,0,0,0,0,0,0,0,0,
0,1285,1285,1285,0,0,0,0,0,0,0,0,0,0,0,0,0,0,0,0,0,0,0,0,0,0,0,0,0,0,0,0,0,0,0,0,0,0,0,0,
0,1317,1317,1317,1285,0,0,0,0,0,0,0,0,0,0,0,0,0,0,0,0,0,0,0,0,0,0,0,0,0,0,0,0,0,0,0,0,0,0,0,
0,0,0,0,1317,0,0,0,0,0,0,0,0,0,0,0,0,0,0,0,0,0,0,0,0,0,0,0,0,0,0,0,0,0,0,0,0,0,0,0,
0,0,0,0,0,0,0,0,0,0,0,0,0,0,0,0,0,0,0,0,0,0,1285,1285,0,0,0,0,0,0,0,0,0,0,0,0,0,0,0,0,
0,0,0,0,0,0,0,0,0,0,0,0,0,0,0,0,0,0,0,0,0,0,1317,1285,1285,0,0,0,0,0,0,0,0,0,0,0,1285,0,0,0,
0,0,0,0,0,0,0,0,0,0,0,0,0,0,0,0,0,0,0,0,0,0,0,1317,1317,0,0,0,0,0,0,0,0,0,0,0,1317,0,0,0,
0,0,0,0,0,0,0,0,0,0,0,0,0,0,0,0,0,0,0,0,0,0,0,0,0,0,0,0,0,0,0,0,0,0,0,0,1317,0,0,0,
0,0,0,0,0,0,0,0,0,0,0,0,0,0,0,0,0,0,0,0,0,0,0,0,0,0,0,0,0,0,0,0,0,0,0,0,0,0,0,0,
1931,1931,1931,1931,1931,1931,1931,1931,1931,1932,0,0,0,0,0,0,0,0,0,0,0,0,0,0,0,0,0,0,0,0,0,0,0,0,0,0,0,0,0,0,
0,0,0,0,0,0,0,0,0,0,0,0,0,0,0,0,0,0,0,0,0,0,0,0,0,0,0,0,0,0,0,0,0,0,0,0,0,0,0,0,
0,0,0,0,0,0,0,0,0,0,0,0,0,0,0,0,0,0,1285,0,0,0,0,0,0,0,0,0,0,0,0,0,0,0,0,0,0,0,0,0,
0,0,0,0,0,0,0,0,0,0,0,0,0,0,0,0,0,0,1317,0,0,0,0,0,0,0,0,0,0,0,0,0,0,0,0,0,0,0,0,0,
0,0,0,0,0,0,0,0,0,0,0,0,0,0,0,0,0,0,0,0,0,0,0,0,0,0,0,0,0,0,0,0,0,0,0,0,0,0,0,0,
0,0,0,0,0,0,0,0,0,0,0,0,0,0,0,0,0,0,0,0,0,0,0,0,0,0,0,0,0,0,0,0,0,0,0,0,0,0,0,0,
0,0,0,0,0,0,0,0,0,0,0,0,0,0,0,0,0,0,0,0,0,0,0,0,0,0,0,0,0,0,0,0,0,0,0,0,0,0,0,0,
0,0,0,0,0,0,0,0,0,0,0,0,0,0,0,0,0,0,0,0,0,0,0,0,0,0,0,0,0,0,0,0,0,0,0,0,0,0,0,0,
0,0,0,0,0,0,0,0,0,0,0,0,0,0,0,0,0,0,0,0,0,0,0,0,0,0,0,0,0,0,1285,0,0,0,0,0,0,0,0,0,
0,0,0,0,0,0,0,0,0,0,1285,0,0,0,0,0,0,0,0,0,0,0,0,0,0,0,0,0,0,0,1285,0,0,0,0,0,0,0,0,0,
0,0,0,0,0,0,0,0,0,1285,1285,0,0,0,0,0,0,0,0,0,0,0,0,0,0,0,0,0,0,0,1285,0,0,0,0,0,0,0,0,0,
0,0,0,0,0,0,0,0,1285,1285,1317,0,0,0,0,0,0,0,0,0,0,0,0,0,0,0,0,0,0,0,1285,1285,0,0,0,0,0,0,0,0,
0,0,0,0,0,0,0,0,1317,1317,0,0,0,0,0,0,0,0,0,0,0,0,0,0,0,0,0,0,0,0,1317,1285,1285,0,0,0,0,0,0,0,
0,0,0,0,0,0,0,0,0,0,0,0,0,0,0,0,0,0,0,0,0,0,0,0,0,0,0,0,0,0,0,1317,1285,0,0,0,0,0,0,0,
0,0,0,0,0,0,0,0,0,0,0,0,0,0,0,0,0,0,0,0,0,0,0,0,0,0,0,0,0,0,0,0,1317,0,0,0,0,0,0,0,
0,0,0,0,0,0,0,0,0,0,0,0,0,0,0,0,0,0,0,0,0,0,0,0,0,0,0,0,0,0,0,0,0,0,0,0,0,0,0,0