40
30
20
500
207,207,75,75,75,75,75,75,75,75,75,75,75,75,75,75,75,75,75,75,75,75,75,75,75,75,75,75,75,75,75,75,75,75,75,75,75,75,75,75,
207,207,207,75,75,75,75,75,75,75,75,75,75,75,75,75,75,75,75,75,75,75,75,75,75,75,75,75,75,75,75,75,75,75,75,75,75,75,75,207,
207,207,207,132,132,132,132,132,132,75,75,75,75,75,75,132,132,132,132,132,132,207,75,75,75,75,75,75,75,75,75,75,75,75,75,75,75,75,75,207,
207,207,207,132,132,964,964,132,132,207,75,75,75,75,207,132,132,965,965,132,132,207,207,207,207,207,75,75,75,75,75,75,75,75,75,75,75,75,207,207,
207,207,207,132,132,964,964,132,132,207,207,207,207,207,207,132,132,965,965,132,132,207,207,207,207,207,207,207,75,75,75,75,75,75,75,207,207,207,207,207,
207,207,207,132,132,132,132,132,132,207,207,207,207,207,207,132,132,132,132,132,132,207,207,207,207,207,207,207,207,207,207,207,207,207,207,207,207,207,207,207,
207,207,207,132,132,132,132,132,132,207,207,207,207,207,207,132,132,132,132,132,132,207,207,207,207,207,207,207,207,207,207,207,207,207,207,207,207,207,207,207,
207,207,207,207,207,207,207,207,207,207,207,207,207,207,207,207,207,207,132,132,132,132,132,132,132,207,207,207,207,207,207,207,207,207,207,207,207,207,207,207,
207,207,207,207,207,207,207,207,207,207,207,207,207,207,207,207,207,207,132,132,132,132,132,132,132,207,207,207,207,207,207,207,207,207,207,207,207,207,207,207,
207,207,207,207,207,207,207,207,207,207,207,207,207,207,207,207,207,207,132,132,132,964,964,132,132,207,207,207,207,207,207,207,207,207,207,207,207,207,207,207,
207,207,207,207,207,207,207,207,207,207,207,207,207,207,207,207,207,207,132,132,132,964,964,207,132,207,207,207,207,207,207,207,207,207,207,207,207,207,207,207,
207,207,207,207,207,207,207,207,207,207,207,80,80,80,80,207,207,207,132,132,132,132,132,132,132,207,207,207,207,207,207,207,132,132,132,132,132,132,207,207,
207,207,207,207,207,207,207,207,207,207,207,80,80,80,80,207,207,207,207,207,207,207,207,207,207,207,207,207,207,207,207,207,132,132,132,132,132,132,207,207,
207,207,207,207,207,207,207,207,207,207,207,80,80,207,80,207,207,207,207,207,207,207,207,207,207,207,207,207,207,207,207,207,132,132,964,964,132,132,207,207,
207,207,207,207,207,207,207,207,207,207,207,80,80,80,80,207,207,207,207,207,207,207,207,207,207,207,207,207,207,207,207,207,132,132,964,964,132,132,207,207,
207,207,207,207,207,207,207,207,207,207,207,207,207,207,207,207,207,207,207,65,65,65,65,65,65,65,207,207,207,207,207,207,132,132,132,132,132,132,207,207,
207,207,207,207,207,207,207,207,207,207,207,207,207,207,207,207,207,207,207,65,65,65,65,65,65,65,207,207,207,207,207,207,207,207,207,207,207,207,207,207,
207,207,207,207,207,207,207,207,207,207,207,207,207,207,207,207,207,207,207,65,65,65,65,65,65,65,207,207,207,207,207,207,207,207,207,207,207,207,207,207,
207,207,207,207,207,207,207,207,207,207,207,207,207,207,207,207,207,207,207,65,65,65,65,65,65,65,207,207,207,207,207,207,207,207,207,207,207,207,207,207,
207,207,207,207,207,207,207,207,207,207,207,207,207,207,207,207,207,207,207,207,207,207,207,207,207,207,207,207,207,207,207,207,207,207,207,207,207,207,207,207,
207,207,207,207,207,207,207,207,207,207,207,207,207,207,207,207,207,207,207,207,207,207,207,207,207,207,207,207,207,207,207,207,207,207,207,207,207,207,207,207,
207,207,207,207,207,207,207,207,207,207,207,207,207,207,207,207,207,207,207,207,207,207,207,207,207,207,207,207,207,207,207,207,207,207,207,207,207,207,207,207,
577,577,207,207,207,207,207,207,207,207,207,207,207,207,207,207,207,207,207,207,132,132,132,132,132,132,132,207,207,207,207,207,207,207,207,207,207,207,207,207,
577,577,577,207,207,207,207,207,207,207,207,207,207,207,207,207,207,207,207,207,132,132,964,964,132,132,132,207,207,207,207,207,207,207,207,207,207,207,207,207,
577,577,577,577,207,207,132,132,132,132,132,132,132,207,207,207,207,207,207,207,132,132,964,964,132,132,132,207,207,207,207,207,207,207,207,207,207,207,75,75,
73,73,73,577,577,577,132,132,964,964,207,132,132,207,207,207,207,207,207,207,132,132,132,132,132,132,132,207,207,207,207,207,207,207,207,75,75,75,75,75,
73,73,73,73,577,577,132,132,964,964,132,132,132,207,207,207,207,207,207,207,207,207,207,207,207,207,207,207,207,207,207,207,75,75,75,75,75,75,75,75,
73,73,73,73,73,73,132,132,132,132,132,132,132,207,207,207,207,207,207,207,207,207,207,207,207,207,207,207,207,75,75,75,75,75,75,75,75,75,75,75,
73,73,73,73,73,73,73,73,73,577,577,207,207,207,207,75,75,75,75,75,75,75,75,75,75,75,75,75,75,75,75,75,75,75,75,75,75,75,75,75,
73,73,73,73,73,73,73,73,73,73,577,75,75,75,75,75,75,75,75,75,75,75,75,75,75,75,75,75,75,75,75,75,75,75,75,75,75,75,75,75
0,1453,0,1611,0,0,0,1611,0,0,0,0,0,1611,0,0,1611,0,0,0,0,1611,0,0,0,0,0,0,1611,1611,0,1611,1611,0,0,1611,0,1611,1611,0,
0,0,1453,0,787,788,787,788,1611,0,0,0,1611,0,1611,0,789,790,789,790,0,0,0,0,1611,1611,0,0,0,0,0,1611,0,0,0,0,0,1611,1611,1453,
0,0,0,0,819,820,819,820,0,0,0,0,0,0,0,0,821,822,821,822,0,1453,0,0,0,0,0,0,0,0,0,0,0,0,0,0,0,0,0,1453,
0,0,0,0,1461,1462,1463,1464,1369,1453,0,0,0,0,1453,0,1365,1366,1367,1368,0,0,1453,1453,1453,1453,0,0,0,0,0,0,0,0,0,0,0,0,1453,0,
0,0,0,1439,1493,1494,1495,1496,1401,0,1453,1453,1453,1453,0,0,1397,1398,1399,1400,1403,1404,0,0,1579,1581,1453,1453,0,0,0,0,0,0,0,1453,1453,1453,0,0,
0,0,0,1471,1525,1526,1527,1528,1206,0,0,0,0,0,0,0,1429,1430,1431,1432,1435,1436,0,0,1612,1613,0,0,1453,1453,1453,1453,1453,1453,1453,0,0,0,0,0,
0,0,0,0,0,0,0,0,0,0,1578,0,0,0,0,0,0,0,0,0,0,0,0,0,0,0,0,0,0,0,0,0,0,0,0,0,0,0,0,0,
0,0,0,0,0,0,0,0,0,0,0,0,0,0,0,0,0,0,0,0,789,790,789,790,0,0,0,0,0,0,0,0,0,0,0,0,0,0,0,0,
0,0,0,0,0,0,0,0,0,0,0,0,0,0,0,0,0,0,0,0,821,822,821,822,0,0,0,0,0,0,0,0,0,0,0,0,0,0,0,0,
0,0,0,0,0,0,0,0,0,0,0,0,0,0,0,0,0,0,0,0,1465,1466,1467,1468,1439,0,0,0,0,0,0,0,0,0,0,0,0,0,0,0,
0,0,0,0,0,0,0,0,0,0,0,0,0,0,0,0,0,0,1403,1404,1497,1498,1499,1500,1471,1550,1582,1583,1584,1583,1552,0,0,0,0,0,0,0,0,0,
0,0,0,0,0,0,0,0,0,0,0,0,1539,1540,0,0,0,0,1435,1436,1529,1530,1531,1532,1607,0,0,0,0,0,0,0,0,789,790,789,790,0,0,0,
0,0,0,0,0,0,0,0,0,0,0,0,1571,1572,0,0,0,0,0,0,0,0,0,0,0,0,0,0,0,0,0,0,0,821,822,821,822,0,0,0,
0,0,0,0,0,0,0,0,0,0,0,0,1603,1604,1565,0,0,0,0,0,0,0,0,0,0,0,0,0,0,0,0,0,1439,1465,1466,1467,1468,0,0,0,
0,0,0,0,0,0,0,0,0,0,0,0,0,0,0,0,0,0,0,0,0,0,0,0,0,0,0,0,0,0,0,0,1471,1497,1498,1499,1500,1239,1240,0,
0,0,0,0,0,0,0,0,0,0,0,0,0,0,0,0,0,0,0,0,0,0,0,0,0,0,0,0,0,0,0,0,1576,1529,1530,1531,1532,1271,1272,0,
0,0,0,0,0,0,0,0,0,0,0,0,0,0,0,0,0,0,0,0,0,0,0,0,0,0,0,0,0,0,0,0,0,0,0,0,0,0,0,0,
0,1971,0,0,0,0,0,1971,0,0,0,0,0,1971,0,0,0,0,1971,0,0,0,0,0,0,0,1971,0,0,0,0,0,1971,0,0,0,0,0,1971,0,
0,2003,0,0,0,0,0,2003,0,0,0,0,0,2003,0,0,0,0,2003,648,0,0,0,0,0,648,2003,0,0,0,0,0,2003,0,0,0,0,0,2003,0,
0,0,0,0,0,0,0,0,0,0,0,0,0,0,0,0,0,0,0,0,0,0,0,0,0,0,0,0,0,0,0,0,0,0,0,0,0,0,0,0,
0,1971,0,0,0,0,0,1971,0,0,0,0,0,1971,0,0,0,0,1971,0,0,0,0,0,0,0,1971,0,0,0,0,0,1971,0,0,0,0,0,1971,0,
0,2003,0,0,0,0,0,2003,0,0,0,0,0,2003,0,0,0,0,2003,0,0,785,786,785,786,0,2003,0,0,0,0,0,2003,0,0,0,0,0,2003,0,
0,0,0,0,0,0,0,0,0,0,0,0,0,0,0,0,0,0,0,0,0,817,818,817,818,0,0,0,1577,0,0,0,0,0,0,0,0,0,0,0,
0,0,0,0,0,0,0,211,212,211,212,0,0,0,0,0,0,0,0,0,0,1465,1466,1467,1468,0,0,0,0,0,0,0,0,0,0,0,0,0,1453,1414,
0,0,0,0,1241,1242,0,243,244,243,244,0,0,0,1579,1581,0,0,0,0,1439,1497,1498,1499,1500,1106,1107,0,0,0,1580,1581,0,0,0,1414,1453,1453,0,1446,
0,0,0,0,1273,1274,1439,1465,1466,1467,1468,0,0,0,1612,1613,0,0,0,0,1471,1529,1530,1531,1532,1138,1139,0,0,0,1612,1613,1453,1453,1453,1446,0,0,0,0,
0,0,0,0,0,0,1471,1497,9,9,1500,0,0,0,0,0,0,0,0,0,0,0,0,0,0,0,0,0,0,1414,1453,1453,0,0,0,0,0,0,0,0,
0,0,0,0,0,0,1575,1529,1530,1531,1532,0,0,0,0,1414,0,1453,1453,1453,1453,1453,1453,1453,1453,1453,1453,1453,1453,1446,0,0,0,0,0,0,0,0,0,0,
0,0,0,0,0,0,0,0,0,0,0,1414,1453,1453,1453,1446,0,0,0,0,0,0,0,0,0,0,0,0,0,0,0,0,0,0,0,0,0,0,0,0,
0,0,0,0,0,0,0,0,0,0,1453,1446,0,0,0,0,0,0,0,0,0,0,0,0,0,0,0,0,0,0,0,0,0,0,0,0,0,0,0,0
0,0,0,0,0,0,0,0,0,0,0,0,0,0,0,0,0,0,0,0,0,0,0,0,0,0,0,0,0,0,0,0,0,0,0,0,0,0,0,0,
0,0,0,0,0,0,0,0,0,0,0,0,0,0,0,0,0,0,0,0,0,0,0,0,0,0,0,0,0,0,0,0,0,0,0,0,0,0,0,0,
0,0,0,0,0,0,0,0,0,0,0,0,0,0,0,0,0,0,0,0,0,0,0,0,0,0,0,0,0,0,0,0,0,0,0,0,0,0,0,0,
0,0,0,0,0,0,0,0,0,0,0,0,0,0,0,0,0,0,0,0,0,0,0,0,0,0,0,0,0,0,0,0,0,0,0,0,0,0,0,0,
0,0,0,0,0,0,0,0,0,0,0,0,0,0,0,0,0,0,0,0,0,0,0,0,0,0,0,0,0,0,0,0,0,0,0,0,0,0,0,0,
0,0,0,0,0,0,0,0,0,0,0,0,0,0,0,0,0,0,0,0,0,0,0,0,0,0,0,0,0,0,0,0,0,0,0,0,0,0,0,0,
0,0,0,0,0,0,0,0,0,0,0,0,0,0,0,0,0,0,0,0,0,0,0,0,0,0,0,0,0,0,0,0,0,0,0,0,0,0,0,0,
0,0,0,0,0,0,0,0,0,0,0,0,0,0,0,0,0,0,0,0,0,0,0,0,0,0,0,0,0,0,0,0,0,0,0,0,0,0,0,0,
0,0,0,0,0,0,0,0,0,0,0,0,0,0,0,0,0,0,0,0,0,0,0,0,0,0,0,0,0,0,0,0,0,0,0,0,0,0,0,0,
0,0,0,0,0,0,0,0,0,0,0,0,0,0,0,0,0,0,0,0,0,1371,1372,0,0,0,0,0,0,0,0,0,0,0,0,0,0,0,0,0,
0,0,0,0,0,0,0,0,0,0,0,0,0,0,0,0,0,0,0,0,0,0,0,0,0,0,0,0,0,0,0,0,0,0,0,0,0,0,0,0,
0,0,0,0,0,0,0,0,0,0,0,0,0,0,0,0,0,0,0,0,0,0,0,0,0,0,0,0,0,0,0,0,0,0,0,0,0,0,0,0,
0,0,0,0,0,0,0,0,0,0,0,0,0,0,0,0,0,0,0,0,0,0,0,0,0,0,0,0,0,0,0,0,0,0,0,0,0,0,0,0,
0,0,0,0,0,0,0,0,0,0,0,0,0,0,0,0,0,0,0,0,0,0,0,0,0,0,0,0,0,0,0,0,0,0,0,0,0,0,0,0,
0,0,0,0,0,0,0,0,0,0,0,0,0,0,0,0,0,0,0,0,0,0,0,0,0,0,0,0,0,0,0,0,0,0,0,0,0,0,0,0,
0,0,0,0,0,0,0,0,0,0,0,0,0,0,0,0,0,0,0,551,551,551,551,551,551,551,0,0,0,0,0,0,0,0,0,0,0,0,0,0,
0,0,0,0,0,0,0,0,0,0,0,0,0,0,0,0,0,0,0,583,583,583,583,583,583,583,0,0,0,0,0,0,0,0,0,0,0,0,0,0,
0,0,0,0,0,0,0,0,0,0,0,0,0,0,0,0,0,0,0,615,647,647,647,647,647,615,0,0,0,0,0,0,0,0,0,0,0,0,0,0,
0,0,0,0,0,0,0,0,0,0,0,0,0,0,0,0,0,0,0,0,0,0,0,0,0,0,0,0,0,0,0,0,0,0,0,0,0,0,0,0,
1931,1931,1931,1931,1931,1931,1931,1931,1931,1931,1931,1931,1931,1931,1931,1931,1931,1931,1931,1931,1931,1931,1931,1931,1931,1931,1931,1931,1931,1931,1931,1931,1931,1931,1931,1931,1931,1931,1931,1932,
0,0,0,0,0,0,0,0,0,0,0,0,0,0,0,0,0,0,0,0,0,0,0,0,0,0,0,0,0,0,0,0,0,0,0,0,0,0,0,0,
0,0,0,0,0,0,0,0,0,0,0,0,0,0,0,0,0,0,0,0,0,0,0,0,0,0,0,0,0,0,0,0,0,0,0,0,0,0,0,0,
0,0,0,0,0,0,0,0,0,0,0,0,0,0,0,0,0,0,0,0,0,0,0,0,0,0,0,0,0,0,0,0,0,0,0,0,0,0,0,0,
0,0,0,0,0,0,0,0,0,0,0,0,0,0,0,0,0,0,0,0,0,0,0,0,0,0,0,0,0,0,0,0,0,0,0,0,0,0,0,0,
0,0,0,0,0,0,0,0,0,0,0,0,0,0,0,0,0,0,0,0,0,0,0,0,0,0,0,0,0,0,0,0,0,0,0,0,0,0,0,0,
0,0,0,0,0,0,0,0,0,0,0,0,0,0,0,0,0,0,0,0,0,0,0,0,0,0,0,0,0,0,0,0,0,0,0,0,0,0,0,0,
0,0,0,0,0,0,0,0,1495,1494,0,0,0,0,0,0,0,0,0,0,0,0,0,0,0,0,0,0,0,0,0,0,0,0,0,0,0,0,0,0,
1026,0,1026,0,0,0,0,0,1527,1526,0,0,0,0,0,0,0,0,0,0,0,0,0,0,0,0,0,0,0,0,0,0,1703,1703,1703,1703,0,1704,1704,1704,
0,0,0,0,0,0,0,0,0,0,0,0,0,0,0,0,0,0,0,0,0,0,0,0,0,0,0,0,0,0,0,0,1703,1703,1703,1703,0,1704,1704,1704,
0,0,0,1026,1026,0,0,0,0,0,0,0,0,0,0,0,0,0,0,1672,1672,1672,1672,1672,1672,1672,1672,1672,1672,1672,0,0,1703,1703,1703,1703,0,1704,1704,1704